allée	allée	Ncafsl
archipel	archipel	Ncamsl
avenue	avenue	Ncafsl
boulevard	boulevard	Ncamsl
butte	butte	Ncafsl
cap	cap	Ncamsl
chemin	chemin	Ncamsl
cité	cité	Ncafsl
cour	cour	Ncafsl
cours	cours	Ncafsl
fontaine	fontaine	Ncafsl
forum	forum	Ncamsl
galerie	galerie	Ncafsl
gare	gare	Ncafsl
golfe	golfe	Ncamsl
hameau	hameau	Ncamsl
île	île	Ncafsl
impasse	impasse	Ncafsl
jardin	jardin	Ncamsl
lac	lac	Ncamsl
marché	marché	Ncamsl
mer	mer	Ncafsl
mont	mont	Ncamsl
océan	océan	Ncamsl
palais	palais	Ncamsl
parc	parc	Ncamsl
passage	passage	Ncamsl
place	place	Ncafsl
planète	planète	Ncafsl
pont	pont	Ncamsl
porte	porte	Ncafsl
puy	puy	Ncamsl
quai	quai	Ncamsl
rue	rue	Ncafsl
sentier	sentier	Ncamsl
square	square	Ncamsl
stade	stade	Ncamsl
tour	tour	Ncafsl
villa	villa	Ncafsl
abbaye	abbaye	Ncafsl
basilique	basilique	Ncafsl
cathédrale	cathédrale	Ncafsl
collégiale	collégiale	Ncafsl
chapelle	chapelle	Ncafsl
église	église	Ncafsl
monastère	monastère	Ncamsl
mosquée	mosquée	Ncafsl
synagogue	synagogue	Ncafsl
temple	temple	Ncamsl
clinique	clinique	Ncafsl
hôpital	hôpital	Ncamsl
maternité	maternité	Ncafsl
polyclinique	polyclinique	Ncafsl
athénée	athénée	Ncamsl
collège	collège	Ncamsl
école	école	Ncafsl
lycée	lycée	Ncamsl
université	université	Ncafsl