abbé	abbé	Ncamsn
adjudant	adjudant	Ncamsn
adjudant-chef	adjudant-chef	Ncamsn
amiral	amiral	Ncamsn
archevêque	archevêque	Ncamsn
archidiacre	archidiacre	Ncamsn
archiduc	archiduc	Ncamsn
archiduchesse	archiduchesse	Ncafsn
aspirant	aspirant	Ncamsn
ayatollah	ayatollah	Ncamsn
baron	baron	Ncamsn
baronne	baronne	Ncafsn
bey	bey	Ncamsn
brigadier	brigadier	Ncamsn
capitaine	capitaine	Ncamsn
capitaine	capitaine	Ncafsn
caporal	caporal	Ncamsn
caporal	caporal	Ncafsn
cardinal	cardinal	Ncamsn
chancelier	chancelier	Ncamsn
chevalier	chevalier	Ncamsn
colonel	colonel	Ncamsn
commandant	commandant	Ncamsn
commissaire	commissaire	Ncamsn
comte	comte	Ncamsn
comtesse	comtesse	Ncafsn
dame	dame	Ncafsn
député	député	Ncamsn
députée	député	Ncafsn
diacre	diacre	Ncamsn
docteur	docteur	Ncamsn
docteur	docteur	Ncafsn
douairière	douairière	Ncafsn
doyen	doyen	Ncamsn
doyenne	doyenne	Ncafsn
duc	duc	Ncamsn
duchesse	duchesse	Ncafsn
émir	émir	Ncamsn
empereur	empereur	Ncamsn
évêque	évêque	Ncamsn
frère	frère	Ncamsn
général	général	Ncamsn
hadj	hadj	Ncamsn
imam	imam	Ncamsn
impératrice	impératrice	Ncafsn
inspecteur	inspecteur	Ncamsn
inspectrice	inspectrice	Ncafsn
khan	khan	Ncamsn
lady	lady	Ncafsn
lieutenant	lieutenant	Ncamsn
lieutenant-colonel	lieutenant-colonel	Ncamsn
lord	lord	Ncamsn
madame	madame	Ncafsn
mademoiselle	mademoiselle	Ncafsn
maître	maître	Ncamsn
maître	maître	Ncafsn
majesté	majesté	Ncamsn
majesté	majesté	Ncafsn
major	major	Ncamsn
maréchal	maréchal	Ncamsn
marquis	marquis	Ncamsn
marquise	marquise	Ncafsn
mère	mère	Ncafsn
ministre	ministre	Ncamsn
ministre	ministre	Ncafsn
monseigneur	monseigneur	Ncamsn
monsieur	monsieur	Ncamsn
pacha	pacha	Ncamsn
pape	pape	Ncamsn
père	père	Ncamsn
pope	pope	Ncamsn
préfet	préfet	Ncamsn
préfète	préfet	Ncafsn
préfet	préfet	Ncafsn
président	président	Ncamsn
présidente	présidente	Ncafsn
prince	prince	Ncamsn
princesse	princesse	Ncafsn
professeur	professeur	Ncamsn
rabbi	rabbi	Ncamsn
rabbin	rabbin	Ncamsn
recteur	recteur	Ncamsn
reine	reine	Ncafsn
roi	roi	Ncamsn
S.A.	S.A.	Ncamsn
S.A.	S.A.	Ncafsn
S.M.	S.M.	Ncamsn
S.M.	S.M.	Ncafsn
saint	saint	Ncamsn
sainte	sainte	Ncafsn
san	san	Ncamsn
santa	santa	Ncafsn
sao	sao	Ncamsn
sénateur	sénateur	Ncamsn
sénatrice	sénateur	Ncafsn
sénateur	sénateur	Ncafsn
sergent	sergent	Ncamsn
shah	shah	Ncamsn
sid	sid	Ncamsn
sidi	sidi	Ncamsn
sieur	sieur	Ncamsn
sir	sir	Ncamsn
sire	sire	Ncamsn
sur	sur	Ncafsn
sultan	sultan	Ncamsn
tsar	tsar	Ncamsn
tsarine	tsarine	Ncafsn
vicaire	vicaire	Ncamsn
vicomte	vicomte	Ncamsn
vicomtesse	vicomtesse	Ncafsn
