abbé	abbé	Ncamsp
archiduc	archiduc	Ncamsp
archiduchesse	archiduchesse	Ncafsp
dame	dame	Ncafsp
empereur	empereur	Ncamsp
frère	frère	Ncamsp
impératrice	impératrice	Ncafsp
lady	lady	Ncafsp
lord	lord	Ncamsp
majesté	majesté	Ncamsp
majesté	majesté	Ncafsp
mère	mère	Ncafsp
pape	pape	Ncamsp
père	père	Ncamsp
pope	pope	Ncamsp
prince	prince	Ncamsp
princesse	princesse	Ncafsp
reine	reine	Ncafsp
roi	roi	Ncamsp
S.A.	S.A.	Ncamsp
S.A.	S.A.	Ncafsp
S.M.	S.M.	Ncamsp
S.M.	S.M.	Ncafsp
saint	saint	Ncamsp
sainte	sainte	Ncafsp
san	san	Ncamsp
santa	santa	Ncafsp
sao	sao	Ncamsp
sur	sur	Ncafsp
tsar	tsar	Ncamsp
tsarine	tsarine	Ncafsp
