abatteur	abatteur	Ncbms-		
abatteurs	abatteur	Ncbmp-		
abbé	abbé	Ncbms-		
abbés	abbé	Ncbmp-		
abouteur	abouteur	Ncbms-		
abouteurs	abouteur	Ncbmp-		
académicien	académicien	Ncbms-		
académiciens	académicien	Ncbmp-		
accessoiriste	accessoiriste	Ncbms-		
accessoiristes	accessoiriste	Ncbmp-		
accompagnateur	accompagnateur	Ncbms-		
accompagnateurs	accompagnateur	Ncbmp-		
accordéoniste	accordéoniste	Ncbms-		
accordéonistes	accordéoniste	Ncbmp-		
accordeur	accordeur	Ncbms-		
accordeurs	accordeur	Ncbmp-		
accoupleur	accoupleur	Ncbms-		
accoupleurs	accoupleur	Ncbmp-		
accouveur	accouveur	Ncbms-		
accouveurs	accouveur	Ncbmp-		
accrocheur	accrocheur	Ncbms-		
accrocheurs	accrocheur	Ncbmp-		
achemineur	achemineur	Ncbms-		
achemineurs	achemineur	Ncbmp-		
acheteur	acheteur	Ncbms-		
acheteurs	acheteur	Ncbmp-		
aciériste	aciériste	Ncbms-		
aciéristes	aciériste	Ncbmp-		
acousticien	acousticien	Ncbms-		
acousticiens	acousticien	Ncbmp-		
acquéreur	acquéreur	Ncbms-		
acquéreurs	acquéreur	Ncbmp-		
acrobate	acrobate	Ncbms-		
acrobates	acrobate	Ncbmp-		
acteur	acteur	Ncbms-		
acteurs	acteur	Ncbmp-		
actuaire	actuaire	Ncbms-		
actuaires	actuaire	Ncbmp-		
acuponcteur	acuponcteur	Ncbms-		
acuponcteurs	acuponcteur	Ncbmp-		
acupuncteur	acupuncteur	Ncbms-		
acupuncteurs	acupuncteur	Ncbmp-		
adaptateur	adaptateur	Ncbms-		
adaptateurs	adaptateur	Ncbmp-		
adjoint	adjoint	Ncbms-		
adjoints	adjoint	Ncbmp-		
adjudant	adjudant	Ncbms-		
adjudants	adjudant	Ncbmp-		
administrateur	administrateur	Ncbms-		
administrateurs	administrateur	Ncbmp-		
aérodynamicien	aérodynamicien	Ncbms-		
aérodynamiciens	aérodynamicien	Ncbmp-		
aérographe	aérographe	Ncbms-		
aérographes	aérographe	Ncbmp-		
aéromodéliste	aéromodéliste	Ncbms-		
aéromodélistes	aéromodéliste	Ncbmp-		
aérostier	aérostier	Ncbms-		
aérostiers	aérostier	Ncbmp-		
afficheur	afficheur	Ncbms-		
afficheurs	afficheur	Ncbmp-		
affichiste	affichiste	Ncbms-		
affichistes	affichiste	Ncbmp-		
affileur	affileur	Ncbms-		
affileurs	affileur	Ncbmp-		
affineur	affineur	Ncbms-		
affineurs	affineur	Ncbmp-		
affouilleur	affouilleur	Ncbms-		
affouilleurs	affouilleur	Ncbmp-		
affranchisseur	affranchisseur	Ncbms-		
affranchisseurs	affranchisseur	Ncbmp-		
affréteur	affréteur	Ncbms-		
affréteurs	affréteur	Ncbmp-		
affuteur	affuteur	Ncbms-		
affuteurs	affuteur	Ncbmp-		
agencier	agencier	Ncbms-		
agenciers	agencier	Ncbmp-		
agent	agent	Ncbms-		
agents	agent	Ncbmp-		
agrafeur	agrafeur	Ncbms-		
agrafeurs	agrafeur	Ncbmp-		
agrandisseur	agrandisseur	Ncbms-		
agrandisseurs	agrandisseur	Ncbmp-		
agréé	agréé	Ncbms-		
agréés	agréé	Ncbmp-		
agréeur	agréeur	Ncbms-		
agréeurs	agréeur	Ncbmp-		
agrégé	agrégé	Ncbms-		
agrégés	agrégé	Ncbmp-		
agriculteur	agriculteur	Ncbms-		
agriculteurs	agriculteur	Ncbmp-		
agronome	agronome	Ncbms-		
agronomes	agronome	Ncbmp-		
agrostologue	agrostologue	Ncbms-		
agrostologues	agrostologue	Ncbmp-		
agrotechnicien	agrotechnicien	Ncbms-		
agrotechniciens	agrotechnicien	Ncbmp-		
aide	aide	Ncbms-		
aides	aide	Ncbmp-		
aiguilleteur	aiguilleteur	Ncbms-		
aiguilleteurs	aiguilleteur	Ncbmp-		
aiguilleur	aiguilleur	Ncbms-		
aiguilleurs	aiguilleur	Ncbmp-		
aiguiseur	aiguiseur	Ncbms-		
aiguiseurs	aiguiseur	Ncbmp-		
ajusteur	ajusteur	Ncbms-		
ajusteurs	ajusteur	Ncbmp-		
alcoologue	alcoologue	Ncbms-		
alcoologues	alcoologue	Ncbmp-		
aléseur	aléseur	Ncbms-		
aléseurs	aléseur	Ncbmp-		
alevineur	alevineur	Ncbms-		
alevineurs	alevineur	Ncbmp-		
algoculteur	algoculteur	Ncbms-		
algoculteurs	algoculteur	Ncbmp-		
algologue	algologue	Ncbms-		
algologues	algologue	Ncbmp-		
alimentateur	alimentateur	Ncbms-		
alimentateurs	alimentateur	Ncbmp-		
allergologue	allergologue	Ncbms-		
allergologues	allergologue	Ncbmp-		
alpiniste	alpiniste	Ncbms-		
alpinistes	alpiniste	Ncbmp-		
alsineur	alsineur	Ncbms-		
alsineurs	alsineur	Ncbmp-		
altiste	altiste	Ncbms-		
altistes	altiste	Ncbmp-		
aluchromiste	aluchromiste	Ncbms-		
aluchromistes	aluchromiste	Ncbmp-		
amareyeur	amareyeur	Ncbms-		
amareyeurs	amareyeur	Ncbmp-		
amateur	amateur	Ncbms-		
amateurs	amateur	Ncbmp-		
ambassadeur	ambassadeur	Ncbms-		
ambassadeurs	ambassadeur	Ncbmp-		
ambulancier	ambulancier	Ncbms-		
ambulanciers	ambulancier	Ncbmp-		
aménageur	aménageur	Ncbms-		
aménageurs	aménageur	Ncbmp-		
amiral	amiral	Ncbms-		
amirals	amiral	Ncbmp-		
amuseur	amuseur	Ncbms-		
amuseurs	amuseur	Ncbmp-		
analyste	analyste	Ncbms-		
analystes	analyste	Ncbmp-		
anatomiste	anatomiste	Ncbms-		
anatomistes	anatomiste	Ncbmp-		
andrologue	andrologue	Ncbms-		
andrologues	andrologue	Ncbmp-		
anesthésiologiste	anesthésiologiste	Ncbms-		
anesthésiologistes	anesthésiologiste	Ncbmp-		
anesthésiste	anesthésiste	Ncbms-		
anesthésistes	anesthésiste	Ncbmp-		
angéiologue	angéiologue	Ncbms-		
angéiologues	angéiologue	Ncbmp-		
angiologue	angiologue	Ncbms-		
angiologues	angiologue	Ncbmp-		
animalier	animalier	Ncbms-		
animaliers	animalier	Ncbmp-		
animateur*	animateur*	Ncbms-		
animateur*s	animateur*	Ncbmp-		
annonceur	annonceur	Ncbms-		
annonceurs	annonceur	Ncbmp-		
anodiseur	anodiseur	Ncbms-		
anodiseurs	anodiseur	Ncbmp-		
anseur	anseur	Ncbms-		
anseurs	anseur	Ncbmp-		
antenniste	antenniste	Ncbms-		
antennistes	antenniste	Ncbmp-		
anthropologue	anthropologue	Ncbms-		
anthropologues	anthropologue	Ncbmp-		
antipodiste	antipodiste	Ncbms-		
antipodistes	antipodiste	Ncbmp-		
antiquaire	antiquaire	Ncbms-		
antiquaires	antiquaire	Ncbmp-		
apiculteur	apiculteur	Ncbms-		
apiculteurs	apiculteur	Ncbmp-		
apiéceur	apiéceur	Ncbms-		
apiéceurs	apiéceur	Ncbmp-		
appareilleur	appareilleur	Ncbms-		
appareilleurs	appareilleur	Ncbmp-		
appariteur	appariteur	Ncbms-		
appariteurs	appariteur	Ncbmp-		
appelant	appelant	Ncbms-		
appelants	appelant	Ncbmp-		
appéreur	appéreur	Ncbms-		
appéreurs	appéreur	Ncbmp-		
applicateur	applicateur	Ncbms-		
applicateurs	applicateur	Ncbmp-		
apprenti	apprenti	Ncbms-		
apprentis	apprenti	Ncbmp-		
apprêteur	apprêteur	Ncbms-		
apprêteurs	apprêteur	Ncbmp-		
approvisionneur	approvisionneur	Ncbms-		
approvisionneurs	approvisionneur	Ncbmp-		
aquaculteur	aquaculteur	Ncbms-		
aquaculteurs	aquaculteur	Ncbmp-		
aquafortiste	aquafortiste	Ncbms-		
aquafortistes	aquafortiste	Ncbmp-		
aquarelliste	aquarelliste	Ncbms-		
aquarellistes	aquarelliste	Ncbmp-		
aquatintiste	aquatintiste	Ncbms-		
aquatintistes	aquatintiste	Ncbmp-		
arbitre	arbitre	Ncbms-		
arbitres	arbitre	Ncbmp-		
arboriculteur	arboriculteur	Ncbms-		
arboriculteurs	arboriculteur	Ncbmp-		
archéologue	archéologue	Ncbms-		
archéologues	archéologue	Ncbmp-		
archéomagnéticien	archéomagnéticien	Ncbms-		
archéomagnéticiens	archéomagnéticien	Ncbmp-		
archetier	archetier	Ncbms-		
archetiers	archetier	Ncbmp-		
architecte	architecte	Ncbms-		
architectes	architecte	Ncbmp-		
archiviste	archiviste	Ncbms-		
archivistes	archiviste	Ncbmp-		
argenteur	argenteur	Ncbms-		
argenteurs	argenteur	Ncbmp-		
argentier	argentier	Ncbms-		
argentiers	argentier	Ncbmp-		
armateur	armateur	Ncbms-		
armateurs	armateur	Ncbmp-		
armurier	armurier	Ncbms-		
armuriers	armurier	Ncbmp-		
aromaticien	aromaticien	Ncbms-		
aromaticiens	aromaticien	Ncbmp-		
arpenteur	arpenteur	Ncbms-		
arpenteurs	arpenteur	Ncbmp-		
arrangeur	arrangeur	Ncbms-		
arrangeurs	arrangeur	Ncbmp-		
arrimeur	arrimeur	Ncbms-		
arrimeurs	arrimeur	Ncbmp-		
arrondisseur	arrondisseur	Ncbms-		
arrondisseurs	arrondisseur	Ncbmp-		
arroseur	arroseur	Ncbms-		
arroseurs	arroseur	Ncbmp-		
artificier	artificier	Ncbms-		
artificiers	artificier	Ncbmp-		
artisan	artisan	Ncbms-		
artisans	artisan	Ncbmp-		
artiste	artiste	Ncbms-		
artistes	artiste	Ncbmp-		
ascensoriste	ascensoriste	Ncbms-		
ascensoristes	ascensoriste	Ncbmp-		
asphalteur	asphalteur	Ncbms-		
asphalteurs	asphalteur	Ncbmp-		
aspigiculteur	aspigiculteur	Ncbms-		
aspigiculteurs	aspigiculteur	Ncbmp-		
aspirant	aspirant	Ncbms-		
aspirants	aspirant	Ncbmp-		
assainisseur	assainisseur	Ncbms-		
assainisseurs	assainisseur	Ncbmp-		
assembleur	assembleur	Ncbms-		
assembleurs	assembleur	Ncbmp-		
assesseur	assesseur	Ncbms-		
assesseurs	assesseur	Ncbmp-		
assistant	assistant	Ncbms-		
assistants	assistant	Ncbmp-		
associé	associé	Ncbms-		
associés	associé	Ncbmp-		
assortisseur	assortisseur	Ncbms-		
assortisseurs	assortisseur	Ncbmp-		
assureur	assureur	Ncbms-		
assureurs	assureur	Ncbmp-		
astaciculteur	astaciculteur	Ncbms-		
astaciculteurs	astaciculteur	Ncbmp-		
astacologue	astacologue	Ncbms-		
astacologues	astacologue	Ncbmp-		
astrologue	astrologue	Ncbms-		
astrologues	astrologue	Ncbmp-		
astrométrologue	astrométrologue	Ncbms-		
astrométrologues	astrométrologue	Ncbmp-		
astronaute	astronaute	Ncbms-		
astronautes	astronaute	Ncbmp-		
astronome	astronome	Ncbms-		
astronomes	astronome	Ncbmp-		
astrophysicien	astrophysicien	Ncbms-		
astrophysiciens	astrophysicien	Ncbmp-		
athlète	athlète	Ncbms-		
athlètes	athlète	Ncbmp-		
atomicien	atomicien	Ncbms-		
atomiciens	atomicien	Ncbmp-		
atomiste	atomiste	Ncbms-		
atomistes	atomiste	Ncbmp-		
atrier	atrier	Ncbms-		
atriers	atrier	Ncbmp-		
attaché	attaché	Ncbms-		
attachés	attaché	Ncbmp-		
attacheur	attacheur	Ncbms-		
attacheurs	attacheur	Ncbmp-		
aubergiste	aubergiste	Ncbms-		
aubergistes	aubergiste	Ncbmp-		
audiésiste	audiésiste	Ncbms-		
audiésistes	audiésiste	Ncbmp-		
audiotypiste	audiotypiste	Ncbms-		
audiotypistes	audiotypiste	Ncbmp-		
audio-vidéotechnicien	audio-vidéotechnicien	Ncbms-		
audio-vidéotechniciens	audio-vidéotechnicien	Ncbmp-		
audio-vidéothécaire	audio-vidéothécaire	Ncbms-		
audio-vidéothécaires	audio-vidéothécaire	Ncbmp-		
auditeur*	auditeur*	Ncbms-		
auditeur*s	auditeur*	Ncbmp-		
augustin	augustin	Ncbms-		
augustins	augustin	Ncbmp-		
aumônier	aumônier	Ncbms-		
aumôniers	aumônier	Ncbmp-		
auteur	auteur	Ncbms-		
auteurs	auteur	Ncbmp-		
autocariste	autocariste	Ncbms-		
autocaristes	autocariste	Ncbmp-		
autoclaviste	autoclaviste	Ncbms-		
autoclavistes	autoclaviste	Ncbmp-		
automate	automate	Ncbms-		
automates	automate	Ncbmp-		
automaticien	automaticien	Ncbms-		
automaticiens	automaticien	Ncbmp-		
automatiseur	automatiseur	Ncbms-		
automatiseurs	automatiseur	Ncbmp-		
autorisateur	autorisateur	Ncbms-		
autorisateurs	autorisateur	Ncbmp-		
auxiliaire	auxiliaire	Ncbms-		
auxiliaires	auxiliaire	Ncbmp-		
aviateur	aviateur	Ncbms-		
aviateurs	aviateur	Ncbmp-		
aviculteur	aviculteur	Ncbms-		
aviculteurs	aviculteur	Ncbmp-		
avionneur	avionneur	Ncbms-		
avionneurs	avionneur	Ncbmp-		
avitailleur	avitailleur	Ncbms-		
avitailleurs	avitailleur	Ncbmp-		
aviveur	aviveur	Ncbms-		
aviveurs	aviveur	Ncbmp-		
avocat	avocat	Ncbms-		
avocats	avocat	Ncbmp-		
avoué	avoué	Ncbms-		
avoués	avoué	Ncbmp-		
ayant-droit	ayant-droit	Ncbms-		
ayant-droits	ayant-droit	Ncbmp-		
baby-sitter	baby-sitter	Ncbms-		
baby-sitters	baby-sitter	Ncbmp-		
bactériologiste	bactériologiste	Ncbms-		
bactériologistes	bactériologiste	Ncbmp-		
bactériologue	bactériologue	Ncbms-		
bactériologues	bactériologue	Ncbmp-		
bagagiste	bagagiste	Ncbms-		
bagagistes	bagagiste	Ncbmp-		
baguiste	baguiste	Ncbms-		
baguistes	baguiste	Ncbmp-		
baigneur	baigneur	Ncbms-		
baigneurs	baigneur	Ncbmp-		
balafongiste	balafongiste	Ncbms-		
balafongistes	balafongiste	Ncbmp-		
balancier	balancier	Ncbms-		
balanciers	balancier	Ncbmp-		
balayeur	balayeur	Ncbms-		
balayeurs	balayeur	Ncbmp-		
balisticien	balisticien	Ncbms-		
balisticiens	balisticien	Ncbmp-		
bancbrocheur	bancbrocheur	Ncbms-		
bancbrocheurs	bancbrocheur	Ncbmp-		
bancheur	bancheur	Ncbms-		
bancheurs	bancheur	Ncbmp-		
bandagiste	bandagiste	Ncbms-		
bandagistes	bandagiste	Ncbmp-		
bandothécaire	bandothécaire	Ncbms-		
bandothécaires	bandothécaire	Ncbmp-		
banjoïste	banjoïste	Ncbms-		
banjoïstes	banjoïste	Ncbmp-		
banquier	banquier	Ncbms-		
banquiers	banquier	Ncbmp-		
barbotteur	barbotteur	Ncbms-		
barbotteurs	barbotteur	Ncbmp-		
bardeautier	bardeautier	Ncbms-		
bardeautiers	bardeautier	Ncbmp-		
bardeur	bardeur	Ncbms-		
bardeurs	bardeur	Ncbmp-		
barman	barman	Ncbms-		
barmans	barman	Ncbmp-		
baron	baron	Ncbms-		
barons	baron	Ncbmp-		
barragiste	barragiste	Ncbms-		
barragistes	barragiste	Ncbmp-		
barreur	barreur	Ncbms-		
barreurs	barreur	Ncbmp-		
basculeur	basculeur	Ncbms-		
basculeurs	basculeur	Ncbmp-		
basketteur	basketteur	Ncbms-		
basketteurs	basketteur	Ncbmp-		
bassiste	bassiste	Ncbms-		
bassistes	bassiste	Ncbmp-		
bateleur	bateleur	Ncbms-		
bateleurs	bateleur	Ncbmp-		
batelier	batelier	Ncbms-		
bateliers	batelier	Ncbmp-		
bâtonnier	bâtonnier	Ncbms-		
bâtonniers	bâtonnier	Ncbmp-		
batteur	batteur	Ncbms-		
batteurs	batteur	Ncbmp-		
bayle*	bayle*	Ncbms-		
bayle*s	bayle*	Ncbmp-		
bénédictin	bénédictin	Ncbms-		
bénédictins	bénédictin	Ncbmp-		
benjamin	benjamin	Ncbms-		
benjamins	benjamin	Ncbmp-		
bennier	bennier	Ncbms-		
benniers	bennier	Ncbmp-		
berger	berger	Ncbms-		
bergers	berger	Ncbmp-		
bernardin	bernardin	Ncbms-		
bernardins	bernardin	Ncbmp-		
bétonneur	bétonneur	Ncbms-		
bétonneurs	bétonneur	Ncbmp-		
bétonnier	bétonnier	Ncbms-		
bétonniers	bétonnier	Ncbmp-		
betteravier	betteravier	Ncbms-		
betteraviers	betteravier	Ncbmp-		
beurrier	beurrier	Ncbms-		
beurriers	beurrier	Ncbmp-		
bibliographe	bibliographe	Ncbms-		
bibliographes	bibliographe	Ncbmp-		
bibliotechnicien	bibliotechnicien	Ncbms-		
bibliotechniciens	bibliotechnicien	Ncbmp-		
bibliothécaire	bibliothécaire	Ncbms-		
bibliothécaires	bibliothécaire	Ncbmp-		
bichonneur	bichonneur	Ncbms-		
bichonneurs	bichonneur	Ncbmp-		
bijoutier	bijoutier	Ncbms-		
bijoutiers	bijoutier	Ncbmp-		
billettiste	billettiste	Ncbms-		
billettistes	billettiste	Ncbmp-		
biologiste	biologiste	Ncbms-		
biologistes	biologiste	Ncbmp-		
bionomiste	bionomiste	Ncbms-		
bionomistes	bionomiste	Ncbmp-		
biseauteur	biseauteur	Ncbms-		
biseauteurs	biseauteur	Ncbmp-		
bitumeur	bitumeur	Ncbms-		
bitumeurs	bitumeur	Ncbmp-		
blanchisseur	blanchisseur	Ncbms-		
blanchisseurs	blanchisseur	Ncbmp-		
bobbeur	bobbeur	Ncbms-		
bobbeurs	bobbeur	Ncbmp-		
bobeur	bobeur	Ncbms-		
bobeurs	bobeur	Ncbmp-		
bobineur	bobineur	Ncbms-		
bobineurs	bobineur	Ncbmp-		
bobinier	bobinier	Ncbms-		
bobiniers	bobinier	Ncbmp-		
boiseur	boiseur	Ncbms-		
boiseurs	boiseur	Ncbmp-		
boisselier	boisselier	Ncbms-		
boisseliers	boisselier	Ncbmp-		
boitier	boitier	Ncbms-		
boitiers	boitier	Ncbmp-		
bombeur	bombeur	Ncbms-		
bombeurs	bombeur	Ncbmp-		
bonbonneur	bonbonneur	Ncbms-		
bonbonneurs	bonbonneur	Ncbmp-		
bonnetier	bonnetier	Ncbms-		
bonnetiers	bonnetier	Ncbmp-		
bordeur	bordeur	Ncbms-		
bordeurs	bordeur	Ncbmp-		
bordureur	bordureur	Ncbms-		
bordureurs	bordureur	Ncbmp-		
borneur	borneur	Ncbms-		
borneurs	borneur	Ncbmp-		
botaniste	botaniste	Ncbms-		
botanistes	botaniste	Ncbmp-		
botteur	botteur	Ncbms-		
botteurs	botteur	Ncbmp-		
bottier	bottier	Ncbms-		
bottiers	bottier	Ncbmp-		
boucher	boucher	Ncbms-		
bouchers	boucher	Ncbmp-		
boucheur	boucheur	Ncbms-		
boucheurs	boucheur	Ncbmp-		
boucholeur	boucholeur	Ncbms-		
boucholeurs	boucholeur	Ncbmp-		
bouchonneur	bouchonneur	Ncbms-		
bouchonneurs	bouchonneur	Ncbmp-		
bouchonnier	bouchonnier	Ncbms-		
bouchonniers	bouchonnier	Ncbmp-		
boudineur	boudineur	Ncbms-		
boudineurs	boudineur	Ncbmp-		
bouilleur	bouilleur	Ncbms-		
bouilleurs	bouilleur	Ncbmp-		
bouilloteur	bouilloteur	Ncbms-		
bouilloteurs	bouilloteur	Ncbmp-		
boulanger	boulanger	Ncbms-		
boulangers	boulanger	Ncbmp-		
bouliste	bouliste	Ncbms-		
boulistes	bouliste	Ncbmp-		
boulonneur	boulonneur	Ncbms-		
boulonneurs	boulonneur	Ncbmp-		
boulonnier	boulonnier	Ncbms-		
boulonniers	boulonnier	Ncbmp-		
bouquiniste	bouquiniste	Ncbms-		
bouquinistes	bouquiniste	Ncbmp-		
bourdonneur	bourdonneur	Ncbms-		
bourdonneurs	bourdonneur	Ncbmp-		
bourrelier	bourrelier	Ncbms-		
bourreliers	bourrelier	Ncbmp-		
bourreur	bourreur	Ncbms-		
bourreurs	bourreur	Ncbmp-		
boursier	boursier	Ncbms-		
boursiers	boursier	Ncbmp-		
bout de table	bout de table	Ncbms-		
bout de tables	bout de table	Ncbmp-		
boutefeu	boutefeu	Ncbms-		
boutefeus	boutefeu	Ncbmp-		
boutonniériste	boutonniériste	Ncbms-		
boutonniéristes	boutonniériste	Ncbmp-		
bouvier	bouvier	Ncbms-		
bouviers	bouvier	Ncbmp-		
boxeur	boxeur	Ncbms-		
boxeurs	boxeur	Ncbmp-		
boyaudier	boyaudier	Ncbms-		
boyaudiers	boyaudier	Ncbmp-		
brancardier	brancardier	Ncbms-		
brancardiers	brancardier	Ncbmp-		
braseur	braseur	Ncbms-		
braseurs	braseur	Ncbmp-		
brasqueur	brasqueur	Ncbms-		
brasqueurs	brasqueur	Ncbmp-		
brasseur	brasseur	Ncbms-		
brasseurs	brasseur	Ncbmp-		
bricoleur	bricoleur	Ncbms-		
bricoleurs	bricoleur	Ncbmp-		
brideur	brideur	Ncbms-		
brideurs	brideur	Ncbmp-		
brigadier	brigadier	Ncbms-		
brigadiers	brigadier	Ncbmp-		
briqueteur	briqueteur	Ncbms-		
briqueteurs	briqueteur	Ncbmp-		
brocanteur	brocanteur	Ncbms-		
brocanteurs	brocanteur	Ncbmp-		
brocheur	brocheur	Ncbms-		
brocheurs	brocheur	Ncbmp-		
brodeur	brodeur	Ncbms-		
brodeurs	brodeur	Ncbmp-		
bronzeur	bronzeur	Ncbms-		
bronzeurs	bronzeur	Ncbmp-		
bronzier	bronzier	Ncbms-		
bronziers	bronzier	Ncbmp-		
brossier	brossier	Ncbms-		
brossiers	brossier	Ncbmp-		
broyeur	broyeur	Ncbms-		
broyeurs	broyeur	Ncbmp-		
bruiteur	bruiteur	Ncbms-		
bruiteurs	bruiteur	Ncbmp-		
brunisseur	brunisseur	Ncbms-		
brunisseurs	brunisseur	Ncbmp-		
buandier	buandier	Ncbms-		
buandiers	buandier	Ncbmp-		
bucheron	bucheron	Ncbms-		
bucherons	bucheron	Ncbmp-		
buffetier	buffetier	Ncbms-		
buffetiers	buffetier	Ncbmp-		
bulbiculteur	bulbiculteur	Ncbms-		
bulbiculteurs	bulbiculteur	Ncbmp-		
buraliste	buraliste	Ncbms-		
buralistes	buraliste	Ncbmp-		
burineur	burineur	Ncbms-		
burineurs	burineur	Ncbmp-		
buronnier	buronnier	Ncbms-		
buronniers	buronnier	Ncbmp-		
cabaretier	cabaretier	Ncbms-		
cabaretiers	cabaretier	Ncbmp-		
câbleur	câbleur	Ncbms-		
câbleurs	câbleur	Ncbmp-		
câblier	câblier	Ncbms-		
câbliers	câblier	Ncbmp-		
cabliste	cabliste	Ncbms-		
cablistes	cabliste	Ncbmp-		
cachetier	cachetier	Ncbms-		
cachetiers	cachetier	Ncbmp-		
cadet	cadet	Ncbms-		
cadets	cadet	Ncbmp-		
cadmieur	cadmieur	Ncbms-		
cadmieurs	cadmieur	Ncbmp-		
cadre	cadre	Ncbms-		
cadres	cadre	Ncbmp-		
cadreur*	cadreur*	Ncbms-		
cadreur*s	cadreur*	Ncbmp-		
cafetier	cafetier	Ncbms-		
cafetiers	cafetier	Ncbmp-		
caissier	caissier	Ncbms-		
caissiers	caissier	Ncbmp-		
calandreur	calandreur	Ncbms-		
calandreurs	calandreur	Ncbmp-		
calculateur	calculateur	Ncbms-		
calculateurs	calculateur	Ncbmp-		
calfat	calfat	Ncbms-		
calfats	calfat	Ncbmp-		
calibreur	calibreur	Ncbms-		
calibreurs	calibreur	Ncbmp-		
calier	calier	Ncbms-		
caliers	calier	Ncbmp-		
calligraphe	calligraphe	Ncbms-		
calligraphes	calligraphe	Ncbmp-		
calorifugeur	calorifugeur	Ncbms-		
calorifugeurs	calorifugeur	Ncbmp-		
calqueur	calqueur	Ncbms-		
calqueurs	calqueur	Ncbmp-		
cambiste	cambiste	Ncbms-		
cambistes	cambiste	Ncbmp-		
camelot	camelot	Ncbms-		
camelots	camelot	Ncbmp-		
camionneur	camionneur	Ncbms-		
camionneurs	camionneur	Ncbmp-		
camiste	camiste	Ncbms-		
camistes	camiste	Ncbmp-		
canalisateur	canalisateur	Ncbms-		
canalisateurs	canalisateur	Ncbmp-		
cancérologue	cancérologue	Ncbms-		
cancérologues	cancérologue	Ncbmp-		
candidat	candidat	Ncbms-		
candidats	candidat	Ncbmp-		
canneteur	canneteur	Ncbms-		
canneteurs	canneteur	Ncbmp-		
canneur	canneur	Ncbms-		
canneurs	canneur	Ncbmp-		
canoteur	canoteur	Ncbms-		
canoteurs	canoteur	Ncbmp-		
canotier	canotier	Ncbms-		
canotiers	canotier	Ncbmp-		
cantinier	cantinier	Ncbms-		
cantiniers	cantinier	Ncbmp-		
cantonnier	cantonnier	Ncbms-		
cantonniers	cantonnier	Ncbmp-		
canut	canut	Ncbms-		
canuts	canut	Ncbmp-		
caoutchouteur	caoutchouteur	Ncbms-		
caoutchouteurs	caoutchouteur	Ncbmp-		
caoutchoutier	caoutchoutier	Ncbms-		
caoutchoutiers	caoutchoutier	Ncbmp-		
capilliculteur	capilliculteur	Ncbms-		
capilliculteurs	capilliculteur	Ncbmp-		
capitaine	capitaine	Ncbms-		
capitaines	capitaine	Ncbmp-		
caporal	caporal	Ncbms-		
caporals	caporal	Ncbmp-		
capucin	capucin	Ncbms-		
capucins	capucin	Ncbmp-		
carbonisateur	carbonisateur	Ncbms-		
carbonisateurs	carbonisateur	Ncbmp-		
carboniseur	carboniseur	Ncbms-		
carboniseurs	carboniseur	Ncbmp-		
carburier	carburier	Ncbms-		
carburiers	carburier	Ncbmp-		
carburologue	carburologue	Ncbms-		
carburologues	carburologue	Ncbmp-		
cardeur	cardeur	Ncbms-		
cardeurs	cardeur	Ncbmp-		
cardier	cardier	Ncbms-		
cardiers	cardier	Ncbmp-		
cardiologue	cardiologue	Ncbms-		
cardiologues	cardiologue	Ncbmp-		
caréneur	caréneur	Ncbms-		
caréneurs	caréneur	Ncbmp-		
caricaturiste	caricaturiste	Ncbms-		
caricaturistes	caricaturiste	Ncbmp-		
carillonneur	carillonneur	Ncbms-		
carillonneurs	carillonneur	Ncbmp-		
cariste	cariste	Ncbms-		
caristes	cariste	Ncbmp-		
carme	carme	Ncbms-		
carmes	carme	Ncbmp-		
carreautier	carreautier	Ncbms-		
carreautiers	carreautier	Ncbmp-		
carreleur	carreleur	Ncbms-		
carreleurs	carreleur	Ncbmp-		
carreur	carreur	Ncbms-		
carreurs	carreur	Ncbmp-		
carrier	carrier	Ncbms-		
carriers	carrier	Ncbmp-		
carrossier	carrossier	Ncbms-		
carrossiers	carrossier	Ncbmp-		
cartier	cartier	Ncbms-		
cartiers	cartier	Ncbmp-		
cartographe	cartographe	Ncbms-		
cartographes	cartographe	Ncbmp-		
cartomancien	cartomancien	Ncbms-		
cartomanciens	cartomancien	Ncbmp-		
cartonnier	cartonnier	Ncbms-		
cartonniers	cartonnier	Ncbmp-		
cartothécaire	cartothécaire	Ncbms-		
cartothécaires	cartothécaire	Ncbmp-		
cascadeur	cascadeur	Ncbms-		
cascadeurs	cascadeur	Ncbmp-		
caséiste	caséiste	Ncbms-		
caséistes	caséiste	Ncbmp-		
casernier	casernier	Ncbms-		
caserniers	casernier	Ncbmp-		
casquettier	casquettier	Ncbms-		
casquettiers	casquettier	Ncbmp-		
casserolier	casserolier	Ncbms-		
casseroliers	casserolier	Ncbmp-		
casseur	casseur	Ncbms-		
casseurs	casseur	Ncbmp-		
catalogueur	catalogueur	Ncbms-		
catalogueurs	catalogueur	Ncbmp-		
catcheur	catcheur	Ncbms-		
catcheurs	catcheur	Ncbmp-		
catéchiste	catéchiste	Ncbms-		
catéchistes	catéchiste	Ncbmp-		
caténairiste	caténairiste	Ncbms-		
caténairistes	caténairiste	Ncbmp-		
cavalier	cavalier	Ncbms-		
cavaliers	cavalier	Ncbmp-		
caveur	caveur	Ncbms-		
caveurs	caveur	Ncbmp-		
caviste	caviste	Ncbms-		
cavistes	caviste	Ncbmp-		
ceinturier	ceinturier	Ncbms-		
ceinturiers	ceinturier	Ncbmp-		
ceinturonnier	ceinturonnier	Ncbms-		
ceinturonniers	ceinturonnier	Ncbmp-		
cellophaneur	cellophaneur	Ncbms-		
cellophaneurs	cellophaneur	Ncbmp-		
cellophaniste	cellophaniste	Ncbms-		
cellophanistes	cellophaniste	Ncbmp-		
cémenteur	cémenteur	Ncbms-		
cémenteurs	cémenteur	Ncbmp-		
cendrier	cendrier	Ncbms-		
cendriers	cendrier	Ncbmp-		
censeur	censeur	Ncbms-		
censeurs	censeur	Ncbmp-		
centralien	centralien	Ncbms-		
centraliens	centralien	Ncbmp-		
centreur	centreur	Ncbms-		
centreurs	centreur	Ncbmp-		
centrifugeur	centrifugeur	Ncbms-		
centrifugeurs	centrifugeur	Ncbmp-		
céramiste	céramiste	Ncbms-		
céramistes	céramiste	Ncbmp-		
céramologue	céramologue	Ncbms-		
céramologues	céramologue	Ncbmp-		
céréaliculteur	céréaliculteur	Ncbms-		
céréaliculteurs	céréaliculteur	Ncbmp-		
céréalier	céréalier	Ncbms-		
céréaliers	céréalier	Ncbmp-		
certifié	certifié	Ncbms-		
certifiés	certifié	Ncbmp-		
chainiste	chainiste	Ncbms-		
chainistes	chainiste	Ncbmp-		
chaisier	chaisier	Ncbms-		
chaisiers	chaisier	Ncbmp-		
chalumiste	chalumiste	Ncbms-		
chalumistes	chalumiste	Ncbmp-		
chamoiseur	chamoiseur	Ncbms-		
chamoiseurs	chamoiseur	Ncbmp-		
champignonniste	champignonniste	Ncbms-		
champignonnistes	champignonniste	Ncbmp-		
chancelier	chancelier	Ncbms-		
chanceliers	chancelier	Ncbmp-		
chanfreineur	chanfreineur	Ncbms-		
chanfreineurs	chanfreineur	Ncbmp-		
changeur	changeur	Ncbms-		
changeurs	changeur	Ncbmp-		
chanoine	chanoine	Ncbms-		
chanoines	chanoine	Ncbmp-		
chansonnier	chansonnier	Ncbms-		
chansonniers	chansonnier	Ncbmp-		
chanteur	chanteur	Ncbms-		
chanteurs	chanteur	Ncbmp-		
chanteur d'opéra*	chanteur d'opéra*	Ncbms-		
chanteur d'opéra*s	chanteur d'opéra*	Ncbmp-		
chantourneur	chantourneur	Ncbms-		
chantourneurs	chantourneur	Ncbmp-		
chapelier	chapelier	Ncbms-		
chapeliers	chapelier	Ncbmp-		
chapiste	chapiste	Ncbms-		
chapistes	chapiste	Ncbmp-		
charbonnier	charbonnier	Ncbms-		
charbonniers	charbonnier	Ncbmp-		
charcutier	charcutier	Ncbms-		
charcutiers	charcutier	Ncbmp-		
chargé	chargé	Ncbms-		
chargés	chargé	Ncbmp-		
chargeur	chargeur	Ncbms-		
chargeurs	chargeur	Ncbmp-		
charpentier	charpentier	Ncbms-		
charpentiers	charpentier	Ncbmp-		
charron	charron	Ncbms-		
charrons	charron	Ncbmp-		
chartreux*	chartreux*	Ncbms-		
chartreux*s	chartreux*	Ncbmp-		
chasseur	chasseur	Ncbms-		
chasseurs	chasseur	Ncbmp-		
chaudiériste	chaudiériste	Ncbms-		
chaudiéristes	chaudiériste	Ncbmp-		
chaudronnier	chaudronnier	Ncbms-		
chaudronniers	chaudronnier	Ncbmp-		
chauffagiste	chauffagiste	Ncbms-		
chauffagistes	chauffagiste	Ncbmp-		
chauffeur	chauffeur	Ncbms-		
chauffeurs	chauffeur	Ncbmp-		
chausseur	chausseur	Ncbms-		
chausseurs	chausseur	Ncbmp-		
chef	chef	Ncbms-		
chefs	chef	Ncbmp-		
cheminot	cheminot	Ncbms-		
cheminots	cheminot	Ncbmp-		
chercheur	chercheur	Ncbms-		
chercheurs	chercheur	Ncbmp-		
chevalier	chevalier	Ncbms-		
chevaliers	chevalier	Ncbmp-		
chevaliériste	chevaliériste	Ncbms-		
chevaliéristes	chevaliériste	Ncbmp-		
chevillard	chevillard	Ncbms-		
chevillards	chevillard	Ncbmp-		
chevrier	chevrier	Ncbms-		
chevriers	chevrier	Ncbmp-		
chiffonnier	chiffonnier	Ncbms-		
chiffonniers	chiffonnier	Ncbmp-		
chiffreur	chiffreur	Ncbms-		
chiffreurs	chiffreur	Ncbmp-		
chimiste	chimiste	Ncbms-		
chimistes	chimiste	Ncbmp-		
chiromancien	chiromancien	Ncbms-		
chiromanciens	chiromancien	Ncbmp-		
chiropracteur	chiropracteur	Ncbms-		
chiropracteurs	chiropracteur	Ncbmp-		
chiropraticien	chiropraticien	Ncbms-		
chiropraticiens	chiropraticien	Ncbmp-		
chirurgien	chirurgien	Ncbms-		
chirurgiens	chirurgien	Ncbmp-		
chlorier	chlorier	Ncbms-		
chloriers	chlorier	Ncbmp-		
chocolatier	chocolatier	Ncbms-		
chocolatiers	chocolatier	Ncbmp-		
choisisseur	choisisseur	Ncbms-		
choisisseurs	choisisseur	Ncbmp-		
chômeur	chômeur	Ncbms-		
chômeurs	chômeur	Ncbmp-		
chorégraphe	chorégraphe	Ncbms-		
chorégraphes	chorégraphe	Ncbmp-		
choriste	choriste	Ncbms-		
choristes	choriste	Ncbmp-		
chromalineur	chromalineur	Ncbms-		
chromalineurs	chromalineur	Ncbmp-		
chromeur	chromeur	Ncbms-		
chromeurs	chromeur	Ncbmp-		
chromiste	chromiste	Ncbms-		
chromistes	chromiste	Ncbmp-		
chromoteur	chromoteur	Ncbms-		
chromoteurs	chromoteur	Ncbmp-		
chroniqueur	chroniqueur	Ncbms-		
chroniqueurs	chroniqueur	Ncbmp-		
chronométreur	chronométreur	Ncbms-		
chronométreurs	chronométreur	Ncbmp-		
chronométrier	chronométrier	Ncbms-		
chronométriers	chronométrier	Ncbmp-		
cigarier	cigarier	Ncbms-		
cigariers	cigarier	Ncbmp-		
cimentier	cimentier	Ncbms-		
cimentiers	cimentier	Ncbmp-		
cinéaste	cinéaste	Ncbms-		
cinéastes	cinéaste	Ncbmp-		
cintreur	cintreur	Ncbms-		
cintreurs	cintreur	Ncbmp-		
cintrier	cintrier	Ncbms-		
cintriers	cintrier	Ncbmp-		
cireur	cireur	Ncbms-		
cireurs	cireur	Ncbmp-		
cisailleur	cisailleur	Ncbms-		
cisailleurs	cisailleur	Ncbmp-		
ciseleur	ciseleur	Ncbms-		
ciseleurs	ciseleur	Ncbmp-		
cistercien	cistercien	Ncbms-		
cisterciens	cistercien	Ncbmp-		
citernier	citernier	Ncbms-		
citerniers	citernier	Ncbmp-		
civiliste	civiliste	Ncbms-		
civilistes	civiliste	Ncbmp-		
clarinettiste	clarinettiste	Ncbms-		
clarinettistes	clarinettiste	Ncbmp-		
classeur	classeur	Ncbms-		
classeurs	classeur	Ncbmp-		
classier	classier	Ncbms-		
classiers	classier	Ncbmp-		
classologue	classologue	Ncbms-		
classologues	classologue	Ncbmp-		
claveciniste	claveciniste	Ncbms-		
clavecinistes	claveciniste	Ncbmp-		
claviste	claviste	Ncbms-		
clavistes	claviste	Ncbmp-		
clerc	clerc	Ncbms-		
clercs	clerc	Ncbmp-		
clicheur	clicheur	Ncbms-		
clicheurs	clicheur	Ncbmp-		
client	client	Ncbms-		
clients	client	Ncbmp-		
climatologue	climatologue	Ncbms-		
climatologues	climatologue	Ncbmp-		
clinicien	clinicien	Ncbms-		
cliniciens	clinicien	Ncbmp-		
cliométricien	cliométricien	Ncbms-		
cliométriciens	cliométricien	Ncbmp-		
cliométriste	cliométriste	Ncbms-		
cliométristes	cliométriste	Ncbmp-		
cliveur	cliveur	Ncbms-		
cliveurs	cliveur	Ncbmp-		
cloueur	cloueur	Ncbms-		
cloueurs	cloueur	Ncbmp-		
clown	clown	Ncbms-		
clowns	clown	Ncbmp-		
cocher	cocher	Ncbms-		
cochers	cocher	Ncbmp-		
coconneur	coconneur	Ncbms-		
coconneurs	coconneur	Ncbmp-		
codeur	codeur	Ncbms-		
codeurs	codeur	Ncbmp-		
codificateur	codificateur	Ncbms-		
codificateurs	codificateur	Ncbmp-		
codifieur	codifieur	Ncbms-		
codifieurs	codifieur	Ncbmp-		
coffretier	coffretier	Ncbms-		
coffretiers	coffretier	Ncbmp-		
coffreur	coffreur	Ncbms-		
coffreurs	coffreur	Ncbmp-		
cogniticien	cogniticien	Ncbms-		
cogniticiens	cogniticien	Ncbmp-		
coiffeur	coiffeur	Ncbms-		
coiffeurs	coiffeur	Ncbmp-		
cokier	cokier	Ncbms-		
cokiers	cokier	Ncbmp-		
collaborateur	collaborateur	Ncbms-		
collaborateurs	collaborateur	Ncbmp-		
collecteur	collecteur	Ncbms-		
collecteurs	collecteur	Ncbmp-		
collègue	collègue	Ncbms-		
collègues	collègue	Ncbmp-		
colleteur	colleteur	Ncbms-		
colleteurs	colleteur	Ncbmp-		
colleur	colleur	Ncbms-		
colleurs	colleur	Ncbmp-		
colonel	colonel	Ncbms-		
colonels	colonel	Ncbmp-		
coloriste	coloriste	Ncbms-		
coloristes	coloriste	Ncbmp-		
colporteur	colporteur	Ncbms-		
colporteurs	colporteur	Ncbmp-		
combattant	combattant	Ncbms-		
combattants	combattant	Ncbmp-		
comédien	comédien	Ncbms-		
comédiens	comédien	Ncbmp-		
comique	comique	Ncbms-		
comiques	comique	Ncbmp-		
commandant	commandant	Ncbms-		
commandants	commandant	Ncbmp-		
commandeur	commandeur	Ncbms-		
commandeurs	commandeur	Ncbmp-		
commentateur	commentateur	Ncbms-		
commentateurs	commentateur	Ncbmp-		
commerçant	commerçant	Ncbms-		
commerçants	commerçant	Ncbmp-		
commercial	commercial	Ncbms-		
commercials	commercial	Ncbmp-		
commis	commis	Ncbms-		
commiss	commis	Ncbmp-		
commissaire	commissaire	Ncbms-		
commissaires	commissaire	Ncbmp-		
commissionnaire	commissionnaire	Ncbms-		
commissionnaires	commissionnaire	Ncbmp-		
communal	communal	Ncbms-		
communals	communal	Ncbmp-		
communard	communard	Ncbms-		
communards	communard	Ncbmp-		
communicateur	communicateur	Ncbms-		
communicateurs	communicateur	Ncbmp-		
communicologue	communicologue	Ncbms-		
communicologues	communicologue	Ncbmp-		
compagnon	compagnon	Ncbms-		
compagnons	compagnon	Ncbmp-		
compétiteur	compétiteur	Ncbms-		
compétiteurs	compétiteur	Ncbmp-		
compograveur	compograveur	Ncbms-		
compograveurs	compograveur	Ncbmp-		
composeur	composeur	Ncbms-		
composeurs	composeur	Ncbmp-		
compositeur	compositeur	Ncbms-		
compositeurs	compositeur	Ncbmp-		
composteur	composteur	Ncbms-		
composteurs	composteur	Ncbmp-		
comptable	comptable	Ncbms-		
comptables	comptable	Ncbmp-		
compteur	compteur	Ncbms-		
compteurs	compteur	Ncbmp-		
comte	comte	Ncbms-		
comtes	comte	Ncbmp-		
concentrateur	concentrateur	Ncbms-		
concentrateurs	concentrateur	Ncbmp-		
concentreur	concentreur	Ncbms-		
concentreurs	concentreur	Ncbmp-		
concepteur	concepteur	Ncbms-		
concepteurs	concepteur	Ncbmp-		
concessionnaire	concessionnaire	Ncbms-		
concessionnaires	concessionnaire	Ncbmp-		
conchyliculteur	conchyliculteur	Ncbms-		
conchyliculteurs	conchyliculteur	Ncbmp-		
concierge	concierge	Ncbms-		
concierges	concierge	Ncbmp-		
conciliateur	conciliateur	Ncbms-		
conciliateurs	conciliateur	Ncbmp-		
conditionneur	conditionneur	Ncbms-		
conditionneurs	conditionneur	Ncbmp-		
conducteur	conducteur	Ncbms-		
conducteurs	conducteur	Ncbmp-		
conduiseur	conduiseur	Ncbms-		
conduiseurs	conduiseur	Ncbmp-		
confectionneur	confectionneur	Ncbms-		
confectionneurs	confectionneur	Ncbmp-		
conférencier	conférencier	Ncbms-		
conférenciers	conférencier	Ncbmp-		
confiseur	confiseur	Ncbms-		
confiseurs	confiseur	Ncbmp-		
confiturier	confiturier	Ncbms-		
confituriers	confiturier	Ncbmp-		
confrère	confrère	Ncbms-		
confrères	confrère	Ncbmp-		
conseil	conseil	Ncbms-		
conseils	conseil	Ncbmp-		
conseiller	conseiller	Ncbms-		
conseillers	conseiller	Ncbmp-		
conservateur	conservateur	Ncbms-		
conservateurs	conservateur	Ncbmp-		
conserveur	conserveur	Ncbms-		
conserveurs	conserveur	Ncbmp-		
consignataire	consignataire	Ncbms-		
consignataires	consignataire	Ncbmp-		
constructeur	constructeur	Ncbms-		
constructeurs	constructeur	Ncbmp-		
consul	consul	Ncbms-		
consuls	consul	Ncbmp-		
consultant	consultant	Ncbms-		
consultants	consultant	Ncbmp-		
conteur	conteur	Ncbms-		
conteurs	conteur	Ncbmp-		
contorsionniste	contorsionniste	Ncbms-		
contorsionnistes	contorsionniste	Ncbmp-		
contractuel	contractuel	Ncbms-		
contractuels	contractuel	Ncbmp-		
contrebassiste	contrebassiste	Ncbms-		
contrebassistes	contrebassiste	Ncbmp-		
contremaitre	contremaitre	Ncbms-		
contremaitres	contremaitre	Ncbmp-		
contrôleur	contrôleur	Ncbms-		
contrôleurs	contrôleur	Ncbmp-		
convers	convers	Ncbms-		
converss	convers	Ncbmp-		
convoyeur	convoyeur	Ncbms-		
convoyeurs	convoyeur	Ncbmp-		
coopérant	coopérant	Ncbms-		
coopérants	coopérant	Ncbmp-		
coordinateur	coordinateur	Ncbms-		
coordinateurs	coordinateur	Ncbmp-		
coordonnateur	coordonnateur	Ncbms-		
coordonnateurs	coordonnateur	Ncbmp-		
copiste	copiste	Ncbms-		
copistes	copiste	Ncbmp-		
coquilleur	coquilleur	Ncbms-		
coquilleurs	coquilleur	Ncbmp-		
cordier	cordier	Ncbms-		
cordiers	cordier	Ncbmp-		
cordonnier	cordonnier	Ncbms-		
cordonniers	cordonnier	Ncbmp-		
cornettiste	cornettiste	Ncbms-		
cornettistes	cornettiste	Ncbmp-		
corniste	corniste	Ncbms-		
cornistes	corniste	Ncbmp-		
correcteur	correcteur	Ncbms-		
correcteurs	correcteur	Ncbmp-		
correspondancier	correspondancier	Ncbms-		
correspondanciers	correspondancier	Ncbmp-		
correspondant	correspondant	Ncbms-		
correspondants	correspondant	Ncbmp-		
corroyeur	corroyeur	Ncbms-		
corroyeurs	corroyeur	Ncbmp-		
corsetier	corsetier	Ncbms-		
corsetiers	corsetier	Ncbmp-		
coryphée	coryphée	Ncbms-		
coryphées	coryphée	Ncbmp-		
cosméticien	cosméticien	Ncbms-		
cosméticiens	cosméticien	Ncbmp-		
cosmétologue	cosmétologue	Ncbms-		
cosmétologues	cosmétologue	Ncbmp-		
cosmologue	cosmologue	Ncbms-		
cosmologues	cosmologue	Ncbmp-		
cosmonaute	cosmonaute	Ncbms-		
cosmonautes	cosmonaute	Ncbmp-		
costumier	costumier	Ncbms-		
costumiers	costumier	Ncbmp-		
coturniculteur	coturniculteur	Ncbms-		
coturniculteurs	coturniculteur	Ncbmp-		
coucheur	coucheur	Ncbms-		
coucheurs	coucheur	Ncbmp-		
couchiste	couchiste	Ncbms-		
couchistes	couchiste	Ncbmp-		
couleur	couleur	Ncbms-		
couleurs	couleur	Ncbmp-		
coulonnier	coulonnier	Ncbms-		
coulonniers	coulonnier	Ncbmp-		
coupeur	coupeur	Ncbms-		
coupeurs	coupeur	Ncbmp-		
coureur	coureur	Ncbms-		
coureurs	coureur	Ncbmp-		
courrier	courrier	Ncbms-		
courriers	courrier	Ncbmp-		
courriériste	courriériste	Ncbms-		
courriéristes	courriériste	Ncbmp-		
coursier	coursier	Ncbms-		
coursiers	coursier	Ncbmp-		
courtier	courtier	Ncbms-		
courtiers	courtier	Ncbmp-		
couseur	couseur	Ncbms-		
couseurs	couseur	Ncbmp-		
coutelier	coutelier	Ncbms-		
couteliers	coutelier	Ncbmp-		
couturier	couturier	Ncbms-		
couturiers	couturier	Ncbmp-		
couturniculteur	couturniculteur	Ncbms-		
couturniculteurs	couturniculteur	Ncbmp-		
couvreur	couvreur	Ncbms-		
couvreurs	couvreur	Ncbmp-		
créateur	créateur	Ncbms-		
créateurs	créateur	Ncbmp-		
créatif	créatif	Ncbms-		
créatifs	créatif	Ncbmp-		
crémier	crémier	Ncbms-		
crémiers	crémier	Ncbmp-		
crêpier	crêpier	Ncbms-		
crêpiers	crêpier	Ncbmp-		
crépisseur	crépisseur	Ncbms-		
crépisseurs	crépisseur	Ncbmp-		
cressiculteur	cressiculteur	Ncbms-		
cressiculteurs	cressiculteur	Ncbmp-		
cribleur	cribleur	Ncbms-		
cribleurs	cribleur	Ncbmp-		
crieur	crieur	Ncbms-		
crieurs	crieur	Ncbmp-		
criminaliste	criminaliste	Ncbms-		
criminalistes	criminaliste	Ncbmp-		
criminologiste	criminologiste	Ncbms-		
criminologistes	criminologiste	Ncbmp-		
criminologue	criminologue	Ncbms-		
criminologues	criminologue	Ncbmp-		
cristallier	cristallier	Ncbms-		
cristalliers	cristallier	Ncbmp-		
cristallographe	cristallographe	Ncbms-		
cristallographes	cristallographe	Ncbmp-		
critique	critique	Ncbms-		
critiques	critique	Ncbmp-		
croissantier	croissantier	Ncbms-		
croissantiers	croissantier	Ncbmp-		
croqueur	croqueur	Ncbms-		
croqueurs	croqueur	Ncbmp-		
croupier	croupier	Ncbms-		
croupiers	croupier	Ncbmp-		
crouponneur	crouponneur	Ncbms-		
crouponneurs	crouponneur	Ncbmp-		
C.R.S.	C.R.S.	Ncbms-		
C.R.S.s	C.R.S.	Ncbmp-		
crustaciculteur	crustaciculteur	Ncbms-		
crustaciculteurs	crustaciculteur	Ncbmp-		
cryogéniste	cryogéniste	Ncbms-		
cryogénistes	cryogéniste	Ncbmp-		
cubilotier	cubilotier	Ncbms-		
cubilotiers	cubilotier	Ncbmp-		
cueilleur	cueilleur	Ncbms-		
cueilleurs	cueilleur	Ncbmp-		
cuiseur	cuiseur	Ncbms-		
cuiseurs	cuiseur	Ncbmp-		
cuisinier	cuisinier	Ncbms-		
cuisiniers	cuisinier	Ncbmp-		
cuisiniste	cuisiniste	Ncbms-		
cuisinistes	cuisiniste	Ncbmp-		
cuivreur	cuivreur	Ncbms-		
cuivreurs	cuivreur	Ncbmp-		
culottier	culottier	Ncbms-		
culottiers	culottier	Ncbmp-		
cultivateur	cultivateur	Ncbms-		
cultivateurs	cultivateur	Ncbmp-		
culturiste	culturiste	Ncbms-		
culturistes	culturiste	Ncbmp-		
cuniculiculteur	cuniculiculteur	Ncbms-		
cuniculiculteurs	cuniculiculteur	Ncbmp-		
curateur	curateur	Ncbms-		
curateurs	curateur	Ncbmp-		
cuviste	cuviste	Ncbms-		
cuvistes	cuviste	Ncbmp-		
cybernéticien	cybernéticien	Ncbms-		
cybernéticiens	cybernéticien	Ncbmp-		
cycliste	cycliste	Ncbms-		
cyclistes	cycliste	Ncbmp-		
cylindreur	cylindreur	Ncbms-		
cylindreurs	cylindreur	Ncbmp-		
cymbaliste	cymbaliste	Ncbms-		
cymbalistes	cymbaliste	Ncbmp-		
cyndinicien	cyndinicien	Ncbms-		
cyndiniciens	cyndinicien	Ncbmp-		
cyniculteur	cyniculteur	Ncbms-		
cyniculteurs	cyniculteur	Ncbmp-		
cytologiste	cytologiste	Ncbms-		
cytologistes	cytologiste	Ncbmp-		
cytologue	cytologue	Ncbms-		
cytologues	cytologue	Ncbmp-		
dalleur	dalleur	Ncbms-		
dalleurs	dalleur	Ncbmp-		
damasquineur	damasquineur	Ncbms-		
damasquineurs	damasquineur	Ncbmp-		
danseur	danseur	Ncbms-		
danseurs	danseur	Ncbmp-		
débardeur	débardeur	Ncbms-		
débardeurs	débardeur	Ncbmp-		
débarrasseur	débarrasseur	Ncbms-		
débarrasseurs	débarrasseur	Ncbmp-		
débâtisseur	débâtisseur	Ncbms-		
débâtisseurs	débâtisseur	Ncbmp-		
débitant	débitant	Ncbms-		
débitants	débitant	Ncbmp-		
débiteur	débiteur	Ncbms-		
débiteurs	débiteur	Ncbmp-		
débobineur	débobineur	Ncbms-		
débobineurs	débobineur	Ncbmp-		
débogueur	débogueur	Ncbms-		
débogueurs	débogueur	Ncbmp-		
débordeur	débordeur	Ncbms-		
débordeurs	débordeur	Ncbmp-		
débosseleur	débosseleur	Ncbms-		
débosseleurs	débosseleur	Ncbmp-		
déboureur	déboureur	Ncbms-		
déboureurs	déboureur	Ncbmp-		
débroussailleur	débroussailleur	Ncbms-		
débroussailleurs	débroussailleur	Ncbmp-		
débruteur	débruteur	Ncbms-		
débruteurs	débruteur	Ncbmp-		
décalabreur	décalabreur	Ncbms-		
décalabreurs	décalabreur	Ncbmp-		
décalqueur	décalqueur	Ncbms-		
décalqueurs	décalqueur	Ncbmp-		
décapeur	décapeur	Ncbms-		
décapeurs	décapeur	Ncbmp-		
décasteur	décasteur	Ncbms-		
décasteurs	décasteur	Ncbmp-		
déchappeur	déchappeur	Ncbms-		
déchappeurs	déchappeur	Ncbmp-		
déchargeur	déchargeur	Ncbms-		
déchargeurs	déchargeur	Ncbmp-		
décideur	décideur	Ncbms-		
décideurs	décideur	Ncbmp-		
déclarant	déclarant	Ncbms-		
déclarants	déclarant	Ncbmp-		
décodeur	décodeur	Ncbms-		
décodeurs	décodeur	Ncbmp-		
décolleteur	décolleteur	Ncbms-		
décolleteurs	décolleteur	Ncbmp-		
décompteur	décompteur	Ncbms-		
décompteurs	décompteur	Ncbmp-		
décontamineur	décontamineur	Ncbms-		
décontamineurs	décontamineur	Ncbmp-		
décorateur	décorateur	Ncbms-		
décorateurs	décorateur	Ncbmp-		
décortiqueur	décortiqueur	Ncbms-		
décortiqueurs	décortiqueur	Ncbmp-		
découpeur	découpeur	Ncbms-		
découpeurs	découpeur	Ncbmp-		
découvreur	découvreur	Ncbms-		
découvreurs	découvreur	Ncbmp-		
décrasseur	décrasseur	Ncbms-		
décrasseurs	décrasseur	Ncbmp-		
décrocheur	décrocheur	Ncbms-		
décrocheurs	décrocheur	Ncbmp-		
dédoubleur	dédoubleur	Ncbms-		
dédoubleurs	dédoubleur	Ncbmp-		
défendeur*	défendeur*	Ncbms-		
défendeur*s	défendeur*	Ncbmp-		
défenseur	défenseur	Ncbms-		
défenseurs	défenseur	Ncbmp-		
déforesteur	déforesteur	Ncbms-		
déforesteurs	déforesteur	Ncbmp-		
déformeur	déformeur	Ncbms-		
déformeurs	déformeur	Ncbmp-		
défourneur	défourneur	Ncbms-		
défourneurs	défourneur	Ncbmp-		
dégauchisseur	dégauchisseur	Ncbms-		
dégauchisseurs	dégauchisseur	Ncbmp-		
dégraisseur	dégraisseur	Ncbms-		
dégraisseurs	dégraisseur	Ncbmp-		
dégrossisseur	dégrossisseur	Ncbms-		
dégrossisseurs	dégrossisseur	Ncbmp-		
dégustateur	dégustateur	Ncbms-		
dégustateurs	dégustateur	Ncbmp-		
délaineur	délaineur	Ncbms-		
délaineurs	délaineur	Ncbmp-		
délégué	délégué	Ncbms-		
délégués	délégué	Ncbmp-		
déligneur	déligneur	Ncbms-		
déligneurs	déligneur	Ncbmp-		
deltiste	deltiste	Ncbms-		
deltistes	deltiste	Ncbmp-		
demandeur	demandeur	Ncbms-		
demandeurs	demandeur	Ncbmp-		
démarcheur	démarcheur	Ncbms-		
démarcheurs	démarcheur	Ncbmp-		
déménageur	déménageur	Ncbms-		
déménageurs	déménageur	Ncbmp-		
démineur	démineur	Ncbms-		
démineurs	démineur	Ncbmp-		
démographe	démographe	Ncbms-		
démographes	démographe	Ncbmp-		
démonstrateur	démonstrateur	Ncbms-		
démonstrateurs	démonstrateur	Ncbmp-		
démonteur	démonteur	Ncbms-		
démonteurs	démonteur	Ncbmp-		
démouleur	démouleur	Ncbms-		
démouleurs	démouleur	Ncbmp-		
dendrochronologiste	dendrochronologiste	Ncbms-		
dendrochronologistes	dendrochronologiste	Ncbmp-		
dendrologue	dendrologue	Ncbms-		
dendrologues	dendrologue	Ncbmp-		
denteleur	denteleur	Ncbms-		
denteleurs	denteleur	Ncbmp-		
dentelier	dentelier	Ncbms-		
denteliers	dentelier	Ncbmp-		
dentellier	dentellier	Ncbms-		
dentelliers	dentellier	Ncbmp-		
dentiste	dentiste	Ncbms-		
dentistes	dentiste	Ncbmp-		
dépanneur	dépanneur	Ncbms-		
dépanneurs	dépanneur	Ncbmp-		
départeur	départeur	Ncbms-		
départeurs	départeur	Ncbmp-		
dépeceur	dépeceur	Ncbms-		
dépeceurs	dépeceur	Ncbmp-		
dépensier	dépensier	Ncbms-		
dépensiers	dépensier	Ncbmp-		
dépileur	dépileur	Ncbms-		
dépileurs	dépileur	Ncbmp-		
dépolisseur	dépolisseur	Ncbms-		
dépolisseurs	dépolisseur	Ncbmp-		
dépositaire	dépositaire	Ncbms-		
dépositaires	dépositaire	Ncbmp-		
dépoteur	dépoteur	Ncbms-		
dépoteurs	dépoteur	Ncbmp-		
dépouilleur	dépouilleur	Ncbms-		
dépouilleurs	dépouilleur	Ncbmp-		
dépoussiéreur	dépoussiéreur	Ncbms-		
dépoussiéreurs	dépoussiéreur	Ncbmp-		
député	député	Ncbms-		
députés	député	Ncbmp-		
dératiseur	dératiseur	Ncbms-		
dératiseurs	dératiseur	Ncbmp-		
dérayeur	dérayeur	Ncbms-		
dérayeurs	dérayeur	Ncbmp-		
dermatologue	dermatologue	Ncbms-		
dermatologues	dermatologue	Ncbmp-		
dérocheur	dérocheur	Ncbms-		
dérocheurs	dérocheur	Ncbmp-		
dérouleur	dérouleur	Ncbms-		
dérouleurs	dérouleur	Ncbmp-		
dérusheur	dérusheur	Ncbms-		
dérusheurs	dérusheur	Ncbmp-		
désinfecteur	désinfecteur	Ncbms-		
désinfecteurs	désinfecteur	Ncbmp-		
désinsectiseur	désinsectiseur	Ncbms-		
désinsectiseurs	désinsectiseur	Ncbmp-		
désosseur	désosseur	Ncbms-		
désosseurs	désosseur	Ncbmp-		
desserveur	desserveur	Ncbms-		
desserveurs	desserveur	Ncbmp-		
dessinateur	dessinateur	Ncbms-		
dessinateurs	dessinateur	Ncbmp-		
détacheur	détacheur	Ncbms-		
détacheurs	détacheur	Ncbmp-		
détaillant	détaillant	Ncbms-		
détaillants	détaillant	Ncbmp-		
détecteur	détecteur	Ncbms-		
détecteurs	détecteur	Ncbmp-		
détective	détective	Ncbms-		
détectives	détective	Ncbmp-		
détenteur	détenteur	Ncbms-		
détenteurs	détenteur	Ncbmp-		
développeur	développeur	Ncbms-		
développeurs	développeur	Ncbmp-		
dévideur	dévideur	Ncbms-		
dévideurs	dévideur	Ncbmp-		
deviseur	deviseur	Ncbms-		
deviseurs	deviseur	Ncbmp-		
diabétologue	diabétologue	Ncbms-		
diabétologues	diabétologue	Ncbmp-		
diacre	diacre	Ncbms-		
diacres	diacre	Ncbmp-		
diagnosticien	diagnosticien	Ncbms-		
diagnosticiens	diagnosticien	Ncbmp-		
diagraphiste	diagraphiste	Ncbms-		
diagraphistes	diagraphiste	Ncbmp-		
dialectologue	dialectologue	Ncbms-		
dialectologues	dialectologue	Ncbmp-		
dialoguiste	dialoguiste	Ncbms-		
dialoguistes	dialoguiste	Ncbmp-		
diamantaire	diamantaire	Ncbms-		
diamantaires	diamantaire	Ncbmp-		
diatypiste	diatypiste	Ncbms-		
diatypistes	diatypiste	Ncbmp-		
didacthécaire	didacthécaire	Ncbms-		
didacthécaires	didacthécaire	Ncbmp-		
didacticien	didacticien	Ncbms-		
didacticiens	didacticien	Ncbmp-		
diéséliste	diéséliste	Ncbms-		
diésélistes	diéséliste	Ncbmp-		
diététicien	diététicien	Ncbms-		
diététiciens	diététicien	Ncbmp-		
diffuseur	diffuseur	Ncbms-		
diffuseurs	diffuseur	Ncbmp-		
dinandier	dinandier	Ncbms-		
dinandiers	dinandier	Ncbmp-		
diplomate	diplomate	Ncbms-		
diplomates	diplomate	Ncbmp-		
diplômé	diplômé	Ncbms-		
diplômés	diplômé	Ncbmp-		
directeur	directeur	Ncbms-		
directeurs	directeur	Ncbmp-		
dirigeant	dirigeant	Ncbms-		
dirigeants	dirigeant	Ncbmp-		
discompteur	discompteur	Ncbms-		
discompteurs	discompteur	Ncbmp-		
discothécaire	discothécaire	Ncbms-		
discothécaires	discothécaire	Ncbmp-		
dispatcheur	dispatcheur	Ncbms-		
dispatcheurs	dispatcheur	Ncbmp-		
disquaire	disquaire	Ncbms-		
disquaires	disquaire	Ncbmp-		
distillateur	distillateur	Ncbms-		
distillateurs	distillateur	Ncbmp-		
distributeur	distributeur	Ncbms-		
distributeurs	distributeur	Ncbmp-		
docker	docker	Ncbms-		
dockers	docker	Ncbmp-		
docteur [médecin]	docteur [médecin]	Ncbms-		
docteur [médecin]s	docteur [médecin]	Ncbmp-		
docteur  [titre universitaire]	docteur  [titre universitaire]	Ncbms-		
docteur  [titre universitaire]s	docteur  [titre universitaire]	Ncbmp-		
doctorant	doctorant	Ncbms-		
doctorants	doctorant	Ncbmp-		
documentaliste	documentaliste	Ncbms-		
documentalistes	documentaliste	Ncbmp-		
doleur	doleur	Ncbms-		
doleurs	doleur	Ncbmp-		
domestique	domestique	Ncbms-		
domestiques	domestique	Ncbmp-		
domestique*	domestique*	Ncbms-		
domestique*s	domestique*	Ncbmp-		
dominicain	dominicain	Ncbms-		
dominicains	dominicain	Ncbmp-		
domoticien	domoticien	Ncbms-		
domoticiens	domoticien	Ncbmp-		
dompteur	dompteur	Ncbms-		
dompteurs	dompteur	Ncbmp-		
donneur	donneur	Ncbms-		
donneurs	donneur	Ncbmp-		
doreur	doreur	Ncbms-		
doreurs	doreur	Ncbmp-		
doseur	doseur	Ncbms-		
doseurs	doseur	Ncbmp-		
douanier	douanier	Ncbms-		
douaniers	douanier	Ncbmp-		
doubleur	doubleur	Ncbms-		
doubleurs	doubleur	Ncbmp-		
doucisseur	doucisseur	Ncbms-		
doucisseurs	doucisseur	Ncbmp-		
doyen	doyen	Ncbms-		
doyens	doyen	Ncbmp-		
dragéiste	dragéiste	Ncbms-		
dragéistes	dragéiste	Ncbmp-		
dragiste	dragiste	Ncbms-		
dragistes	dragiste	Ncbmp-		
dramaturge	dramaturge	Ncbms-		
dramaturges	dramaturge	Ncbmp-		
drapier	drapier	Ncbms-		
drapiers	drapier	Ncbmp-		
dresseur	dresseur	Ncbms-		
dresseurs	dresseur	Ncbmp-		
droguiste	droguiste	Ncbms-		
droguistes	droguiste	Ncbmp-		
duc	duc	Ncbms-		
ducs	duc	Ncbmp-		
ébarbeur	ébarbeur	Ncbms-		
ébarbeurs	ébarbeur	Ncbmp-		
ébardeur	ébardeur	Ncbms-		
ébardeurs	ébardeur	Ncbmp-		
ébaucheur	ébaucheur	Ncbms-		
ébaucheurs	ébaucheur	Ncbmp-		
ébavureur	ébavureur	Ncbms-		
ébavureurs	ébavureur	Ncbmp-		
ébéniste	ébéniste	Ncbms-		
ébénistes	ébéniste	Ncbmp-		
éboueur	éboueur	Ncbms-		
éboueurs	éboueur	Ncbmp-		
écailler	écailler	Ncbms-		
écaillers	écailler	Ncbmp-		
échafaudeur	échafaudeur	Ncbms-		
échafaudeurs	échafaudeur	Ncbmp-		
échantillonneur	échantillonneur	Ncbms-		
échantillonneurs	échantillonneur	Ncbmp-		
écharneur	écharneur	Ncbms-		
écharneurs	écharneur	Ncbmp-		
échiniculteur	échiniculteur	Ncbms-		
échiniculteurs	échiniculteur	Ncbmp-		
échographe	échographe	Ncbms-		
échographes	échographe	Ncbmp-		
éclairagiste	éclairagiste	Ncbms-		
éclairagistes	éclairagiste	Ncbmp-		
éclateur	éclateur	Ncbms-		
éclateurs	éclateur	Ncbmp-		
éclusier	éclusier	Ncbms-		
éclusiers	éclusier	Ncbmp-		
écologiste	écologiste	Ncbms-		
écologistes	écologiste	Ncbmp-		
écologue	écologue	Ncbms-		
écologues	écologue	Ncbmp-		
économe	économe	Ncbms-		
économes	économe	Ncbmp-		
économiste	économiste	Ncbms-		
économistes	économiste	Ncbmp-		
écorceur	écorceur	Ncbms-		
écorceurs	écorceur	Ncbmp-		
écotoxicologue	écotoxicologue	Ncbms-		
écotoxicologues	écotoxicologue	Ncbmp-		
écoutant	écoutant	Ncbms-		
écoutants	écoutant	Ncbmp-		
écrivain	écrivain	Ncbms-		
écrivains	écrivain	Ncbmp-		
écuyer	écuyer	Ncbms-		
écuyers	écuyer	Ncbmp-		
éditeur	éditeur	Ncbms-		
éditeurs	éditeur	Ncbmp-		
éditorialiste	éditorialiste	Ncbms-		
éditorialistes	éditorialiste	Ncbmp-		
éducateur	éducateur	Ncbms-		
éducateurs	éducateur	Ncbmp-		
effilocheur	effilocheur	Ncbms-		
effilocheurs	effilocheur	Ncbmp-		
effleureur	effleureur	Ncbms-		
effleureurs	effleureur	Ncbmp-		
égaliseur	égaliseur	Ncbms-		
égaliseurs	égaliseur	Ncbmp-		
égoutier	égoutier	Ncbms-		
égoutiers	égoutier	Ncbmp-		
égreneur	égreneur	Ncbms-		
égreneurs	égreneur	Ncbmp-		
élagueur	élagueur	Ncbms-		
élagueurs	élagueur	Ncbmp-		
élanceur	élanceur	Ncbms-		
élanceurs	élanceur	Ncbmp-		
élastiqueur	élastiqueur	Ncbms-		
élastiqueurs	élastiqueur	Ncbmp-		
électeur	électeur	Ncbms-		
électeurs	électeur	Ncbmp-		
électricien	électricien	Ncbms-		
électriciens	électricien	Ncbmp-		
électromazoutier	électromazoutier	Ncbms-		
électromazoutiers	électromazoutier	Ncbmp-		
électroménagiste	électroménagiste	Ncbms-		
électroménagistes	électroménagiste	Ncbmp-		
électronicien	électronicien	Ncbms-		
électroniciens	électronicien	Ncbmp-		
électroplaste	électroplaste	Ncbms-		
électroplastes	électroplaste	Ncbmp-		
éleveur	éleveur	Ncbms-		
éleveurs	éleveur	Ncbmp-		
élingueur	élingueur	Ncbms-		
élingueurs	élingueur	Ncbmp-		
émailleur	émailleur	Ncbms-		
émailleurs	émailleur	Ncbmp-		
emballeur	emballeur	Ncbms-		
emballeurs	emballeur	Ncbmp-		
embaumeur	embaumeur	Ncbms-		
embaumeurs	embaumeur	Ncbmp-		
embosseur	embosseur	Ncbms-		
embosseurs	embosseur	Ncbmp-		
embouteilleur	embouteilleur	Ncbms-		
embouteilleurs	embouteilleur	Ncbmp-		
emboutisseur	emboutisseur	Ncbms-		
emboutisseurs	emboutisseur	Ncbmp-		
émetteur	émetteur	Ncbms-		
émetteurs	émetteur	Ncbmp-		
empailleur	empailleur	Ncbms-		
empailleurs	empailleur	Ncbmp-		
empaqueteur	empaqueteur	Ncbms-		
empaqueteurs	empaqueteur	Ncbmp-		
empâteur	empâteur	Ncbms-		
empâteurs	empâteur	Ncbmp-		
empereur	empereur	Ncbms-		
empereurs	empereur	Ncbmp-		
empileur	empileur	Ncbms-		
empileurs	empileur	Ncbmp-		
employé	employé	Ncbms-		
employés	employé	Ncbmp-		
employeur	employeur	Ncbms-		
employeurs	employeur	Ncbmp-		
empoteur	empoteur	Ncbms-		
empoteurs	empoteur	Ncbmp-		
énarque	énarque	Ncbms-		
énarques	énarque	Ncbmp-		
encadreur	encadreur	Ncbms-		
encadreurs	encadreur	Ncbmp-		
encageur	encageur	Ncbms-		
encageurs	encageur	Ncbmp-		
encaisseur	encaisseur	Ncbms-		
encaisseurs	encaisseur	Ncbmp-		
encartoucheur	encartoucheur	Ncbms-		
encartoucheurs	encartoucheur	Ncbmp-		
encasteur	encasteur	Ncbms-		
encasteurs	encasteur	Ncbmp-		
encimenteur	encimenteur	Ncbms-		
encimenteurs	encimenteur	Ncbmp-		
encodeur	encodeur	Ncbms-		
encodeurs	encodeur	Ncbmp-		
encolleur	encolleur	Ncbms-		
encolleurs	encolleur	Ncbmp-		
endivier	endivier	Ncbms-		
endiviers	endivier	Ncbmp-		
endocrinologue	endocrinologue	Ncbms-		
endocrinologues	endocrinologue	Ncbmp-		
enducteur	enducteur	Ncbms-		
enducteurs	enducteur	Ncbmp-		
enduiseur	enduiseur	Ncbms-		
enduiseurs	enduiseur	Ncbmp-		
énergéticien	énergéticien	Ncbms-		
énergéticiens	énergéticien	Ncbmp-		
enfileur	enfileur	Ncbms-		
enfileurs	enfileur	Ncbmp-		
enfourneur	enfourneur	Ncbms-		
enfourneurs	enfourneur	Ncbmp-		
engazonneur	engazonneur	Ncbms-		
engazonneurs	engazonneur	Ncbmp-		
englobeur	englobeur	Ncbms-		
englobeurs	englobeur	Ncbmp-		
engraisseur	engraisseur	Ncbms-		
engraisseurs	engraisseur	Ncbmp-		
enliasseur	enliasseur	Ncbms-		
enliasseurs	enliasseur	Ncbmp-		
enlumineur	enlumineur	Ncbms-		
enlumineurs	enlumineur	Ncbmp-		
enquêteur	enquêteur	Ncbms-		
enquêteurs	enquêteur	Ncbmp-		
enrouleur	enrouleur	Ncbms-		
enrouleurs	enrouleur	Ncbmp-		
ensacheur	ensacheur	Ncbms-		
ensacheurs	ensacheur	Ncbmp-		
enseignant	enseignant	Ncbms-		
enseignants	enseignant	Ncbmp-		
enseigne	enseigne	Ncbms-		
enseignes	enseigne	Ncbmp-		
ensemblier	ensemblier	Ncbms-		
ensembliers	ensemblier	Ncbmp-		
ensileur	ensileur	Ncbms-		
ensileurs	ensileur	Ncbmp-		
ensimeur	ensimeur	Ncbms-		
ensimeurs	ensimeur	Ncbmp-		
entomologiste	entomologiste	Ncbms-		
entomologistes	entomologiste	Ncbmp-		
entraineur	entraineur	Ncbms-		
entraineurs	entraineur	Ncbmp-		
entremétier	entremétier	Ncbms-		
entremétiers	entremétier	Ncbmp-		
entrepositaire	entrepositaire	Ncbms-		
entrepositaires	entrepositaire	Ncbmp-		
entrepreneur	entrepreneur	Ncbms-		
entrepreneurs	entrepreneur	Ncbmp-		
entringleur	entringleur	Ncbms-		
entringleurs	entringleur	Ncbmp-		
épailleur	épailleur	Ncbms-		
épailleurs	épailleur	Ncbmp-		
épéiste	épéiste	Ncbms-		
épéistes	épéiste	Ncbmp-		
épépineur	épépineur	Ncbms-		
épépineurs	épépineur	Ncbmp-		
épicier	épicier	Ncbms-		
épiciers	épicier	Ncbmp-		
épigraphiste	épigraphiste	Ncbms-		
épigraphistes	épigraphiste	Ncbmp-		
épistémologiste	épistémologiste	Ncbms-		
épistémologistes	épistémologiste	Ncbmp-		
épistémologue	épistémologue	Ncbms-		
épistémologues	épistémologue	Ncbmp-		
éplucheur	éplucheur	Ncbms-		
éplucheurs	éplucheur	Ncbmp-		
éprouveur	éprouveur	Ncbms-		
éprouveurs	éprouveur	Ncbmp-		
épurateur	épurateur	Ncbms-		
épurateurs	épurateur	Ncbmp-		
équarrisseur	équarrisseur	Ncbms-		
équarrisseurs	équarrisseur	Ncbmp-		
équilibriste	équilibriste	Ncbms-		
équilibristes	équilibriste	Ncbmp-		
équipementier	équipementier	Ncbms-		
équipementiers	équipementier	Ncbmp-		
équipier	équipier	Ncbms-		
équipiers	équipier	Ncbmp-		
ergolier	ergolier	Ncbms-		
ergoliers	ergolier	Ncbmp-		
ergonome	ergonome	Ncbms-		
ergonomes	ergonome	Ncbmp-		
ergonomiste	ergonomiste	Ncbms-		
ergonomistes	ergonomiste	Ncbmp-		
escaliéteur	escaliéteur	Ncbms-		
escaliéteurs	escaliéteur	Ncbmp-		
eschatologue	eschatologue	Ncbms-		
eschatologues	eschatologue	Ncbmp-		
escrimeur	escrimeur	Ncbms-		
escrimeurs	escrimeur	Ncbmp-		
espion	espion	Ncbms-		
espions	espion	Ncbmp-		
essayeur	essayeur	Ncbms-		
essayeurs	essayeur	Ncbmp-		
essayiste	essayiste	Ncbms-		
essayistes	essayiste	Ncbmp-		
essencier	essencier	Ncbms-		
essenciers	essencier	Ncbmp-		
essoreur	essoreur	Ncbms-		
essoreurs	essoreur	Ncbmp-		
essuyeur	essuyeur	Ncbms-		
essuyeurs	essuyeur	Ncbmp-		
estampeur	estampeur	Ncbms-		
estampeurs	estampeur	Ncbmp-		
esthéticien	esthéticien	Ncbms-		
esthéticiens	esthéticien	Ncbmp-		
estimateur	estimateur	Ncbms-		
estimateurs	estimateur	Ncbmp-		
étager	étager	Ncbms-		
étagers	étager	Ncbmp-		
étalagiste	étalagiste	Ncbms-		
étalagistes	étalagiste	Ncbmp-		
étalonneur	étalonneur	Ncbms-		
étalonneurs	étalonneur	Ncbmp-		
étalonnier	étalonnier	Ncbms-		
étalonniers	étalonnier	Ncbmp-		
étameur	étameur	Ncbms-		
étameurs	étameur	Ncbmp-		
étampeur	étampeur	Ncbms-		
étampeurs	étampeur	Ncbmp-		
étanchéiste	étanchéiste	Ncbms-		
étanchéistes	étanchéiste	Ncbmp-		
étancheur	étancheur	Ncbms-		
étancheurs	étancheur	Ncbmp-		
étavillonneur	étavillonneur	Ncbms-		
étavillonneurs	étavillonneur	Ncbmp-		
étayeur	étayeur	Ncbms-		
étayeurs	étayeur	Ncbmp-		
étheirologue	étheirologue	Ncbms-		
étheirologues	étheirologue	Ncbmp-		
ethnographe	ethnographe	Ncbms-		
ethnographes	ethnographe	Ncbmp-		
ethnologue	ethnologue	Ncbms-		
ethnologues	ethnologue	Ncbmp-		
éthologiste	éthologiste	Ncbms-		
éthologistes	éthologiste	Ncbmp-		
éthologue	éthologue	Ncbms-		
éthologues	éthologue	Ncbmp-		
étinceleur	étinceleur	Ncbms-		
étinceleurs	étinceleur	Ncbmp-		
étiologue	étiologue	Ncbms-		
étiologues	étiologue	Ncbmp-		
étiqueteur	étiqueteur	Ncbms-		
étiqueteurs	étiqueteur	Ncbmp-		
étirageur	étirageur	Ncbms-		
étirageurs	étirageur	Ncbmp-		
étireur	étireur	Ncbms-		
étireurs	étireur	Ncbmp-		
étringleur	étringleur	Ncbms-		
étringleurs	étringleur	Ncbmp-		
étudiant	étudiant	Ncbms-		
étudiants	étudiant	Ncbmp-		
étuviste	étuviste	Ncbms-		
étuvistes	étuviste	Ncbmp-		
étymologiste	étymologiste	Ncbms-		
étymologistes	étymologiste	Ncbmp-		
évaluateur	évaluateur	Ncbms-		
évaluateurs	évaluateur	Ncbmp-		
évangéliste	évangéliste	Ncbms-		
évangélistes	évangéliste	Ncbmp-		
évaporeur	évaporeur	Ncbms-		
évaporeurs	évaporeur	Ncbmp-		
évêque	évêque	Ncbms-		
évêques	évêque	Ncbmp-		
éviscérateur	éviscérateur	Ncbms-		
éviscérateurs	éviscérateur	Ncbmp-		
examinateur	examinateur	Ncbms-		
examinateurs	examinateur	Ncbmp-		
exécuteur	exécuteur	Ncbms-		
exécuteurs	exécuteur	Ncbmp-		
exorciseur	exorciseur	Ncbms-		
exorciseurs	exorciseur	Ncbmp-		
exorciste*	exorciste*	Ncbms-		
exorciste*s	exorciste*	Ncbmp-		
expéditeur	expéditeur	Ncbms-		
expéditeurs	expéditeur	Ncbmp-		
expéditionnaire	expéditionnaire	Ncbms-		
expéditionnaires	expéditionnaire	Ncbmp-		
expérimentateur	expérimentateur	Ncbms-		
expérimentateurs	expérimentateur	Ncbmp-		
expert	expert	Ncbms-		
experts	expert	Ncbmp-		
exploitant	exploitant	Ncbms-		
exploitants	exploitant	Ncbmp-		
exportateur	exportateur	Ncbms-		
exportateurs	exportateur	Ncbmp-		
exprimeur	exprimeur	Ncbms-		
exprimeurs	exprimeur	Ncbmp-		
externe	externe	Ncbms-		
externes	externe	Ncbmp-		
extra	extra	Ncbms-		
extras	extra	Ncbmp-		
extracteur	extracteur	Ncbms-		
extracteurs	extracteur	Ncbmp-		
extrudeur	extrudeur	Ncbms-		
extrudeurs	extrudeur	Ncbmp-		
fabricant	fabricant	Ncbms-		
fabricants	fabricant	Ncbmp-		
fabuliste	fabuliste	Ncbms-		
fabulistes	fabuliste	Ncbmp-		
façadier	façadier	Ncbms-		
façadiers	façadier	Ncbmp-		
facilitateur	facilitateur	Ncbms-		
facilitateurs	facilitateur	Ncbmp-		
façonneur	façonneur	Ncbms-		
façonneurs	façonneur	Ncbmp-		
façonnier	façonnier	Ncbms-		
façonniers	façonnier	Ncbmp-		
facteur	facteur	Ncbms-		
facteurs	facteur	Ncbmp-		
factotum	factotum	Ncbms-		
factotums	factotum	Ncbmp-		
facturier	facturier	Ncbms-		
facturiers	facturier	Ncbmp-		
facturiste	facturiste	Ncbms-		
facturistes	facturiste	Ncbmp-		
faïencier	faïencier	Ncbms-		
faïenciers	faïencier	Ncbmp-		
fakir	fakir	Ncbms-		
fakirs	fakir	Ncbmp-		
fantaisiste	fantaisiste	Ncbms-		
fantaisistes	fantaisiste	Ncbmp-		
faquir	faquir	Ncbms-		
faquirs	faquir	Ncbmp-		
farinier	farinier	Ncbms-		
fariniers	farinier	Ncbmp-		
fendeur	fendeur	Ncbms-		
fendeurs	fendeur	Ncbmp-		
ferblantier	ferblantier	Ncbms-		
ferblantiers	ferblantier	Ncbmp-		
fermentateur	fermentateur	Ncbms-		
fermentateurs	fermentateur	Ncbmp-		
fermenteur	fermenteur	Ncbms-		
fermenteurs	fermenteur	Ncbmp-		
fermier	fermier	Ncbms-		
fermiers	fermier	Ncbmp-		
ferrailleur	ferrailleur	Ncbms-		
ferrailleurs	ferrailleur	Ncbmp-		
ferreur	ferreur	Ncbms-		
ferreurs	ferreur	Ncbmp-		
ferronnier	ferronnier	Ncbms-		
ferronniers	ferronnier	Ncbmp-		
festonneur	festonneur	Ncbms-		
festonneurs	festonneur	Ncbmp-		
feuillagiste	feuillagiste	Ncbms-		
feuillagistes	feuillagiste	Ncbmp-		
feuillardier	feuillardier	Ncbms-		
feuillardiers	feuillardier	Ncbmp-		
feuilletoniste	feuilletoniste	Ncbms-		
feuilletonistes	feuilletoniste	Ncbmp-		
feutrier	feutrier	Ncbms-		
feutriers	feutrier	Ncbmp-		
figurant	figurant	Ncbms-		
figurants	figurant	Ncbmp-		
fil-de-fériste	fil-de-fériste	Ncbms-		
fil-de-féristes	fil-de-fériste	Ncbmp-		
fileur	fileur	Ncbms-		
fileurs	fileur	Ncbmp-		
fileyeur	fileyeur	Ncbms-		
fileyeurs	fileyeur	Ncbmp-		
filiériste	filiériste	Ncbms-		
filiéristes	filiériste	Ncbmp-		
filigraniste	filigraniste	Ncbms-		
filigranistes	filigraniste	Ncbmp-		
filtreur	filtreur	Ncbms-		
filtreurs	filtreur	Ncbmp-		
financier	financier	Ncbms-		
financiers	financier	Ncbmp-		
fineur	fineur	Ncbms-		
fineurs	fineur	Ncbmp-		
finisseur	finisseur	Ncbms-		
finisseurs	finisseur	Ncbmp-		
fiscaliste	fiscaliste	Ncbms-		
fiscalistes	fiscaliste	Ncbmp-		
flaconnier	flaconnier	Ncbms-		
flaconniers	flaconnier	Ncbmp-		
flasheur	flasheur	Ncbms-		
flasheurs	flasheur	Ncbmp-		
fleurettiste	fleurettiste	Ncbms-		
fleurettistes	fleurettiste	Ncbmp-		
fleuriste	fleuriste	Ncbms-		
fleuristes	fleuriste	Ncbmp-		
flexographe	flexographe	Ncbms-		
flexographes	flexographe	Ncbmp-		
floqueur	floqueur	Ncbms-		
floqueurs	floqueur	Ncbmp-		
floriculteur	floriculteur	Ncbms-		
floriculteurs	floriculteur	Ncbmp-		
fluidicien	fluidicien	Ncbms-		
fluidiciens	fluidicien	Ncbmp-		
flutiste	flutiste	Ncbms-		
flutistes	flutiste	Ncbmp-		
fonceur	fonceur	Ncbms-		
fonceurs	fonceur	Ncbmp-		
fonctionnaire	fonctionnaire	Ncbms-		
fonctionnaires	fonctionnaire	Ncbmp-		
fondé	fondé	Ncbms-		
fondés	fondé	Ncbmp-		
fondeur	fondeur	Ncbms-		
fondeurs	fondeur	Ncbmp-		
fontainier	fontainier	Ncbms-		
fontainiers	fontainier	Ncbmp-		
fontenier	fontenier	Ncbms-		
fonteniers	fontenier	Ncbmp-		
footballeur	footballeur	Ncbms-		
footballeurs	footballeur	Ncbmp-		
forain	forain	Ncbms-		
forains	forain	Ncbmp-		
forestier	forestier	Ncbms-		
forestiers	forestier	Ncbmp-		
foreur	foreur	Ncbms-		
foreurs	foreur	Ncbmp-		
forfaitiste	forfaitiste	Ncbms-		
forfaitistes	forfaitiste	Ncbmp-		
forgeron	forgeron	Ncbms-		
forgerons	forgeron	Ncbmp-		
formateur	formateur	Ncbms-		
formateurs	formateur	Ncbmp-		
formeur	formeur	Ncbms-		
formeurs	formeur	Ncbmp-		
formier	formier	Ncbms-		
formiers	formier	Ncbmp-		
formiste	formiste	Ncbms-		
formistes	formiste	Ncbmp-		
fossoyeur	fossoyeur	Ncbms-		
fossoyeurs	fossoyeur	Ncbmp-		
fouleur	fouleur	Ncbms-		
fouleurs	fouleur	Ncbmp-		
foulonnier	foulonnier	Ncbms-		
foulonniers	foulonnier	Ncbmp-		
fournier	fournier	Ncbms-		
fourniers	fournier	Ncbmp-		
fournisseur	fournisseur	Ncbms-		
fournisseurs	fournisseur	Ncbmp-		
fourreur	fourreur	Ncbms-		
fourreurs	fourreur	Ncbmp-		
fourrier	fourrier	Ncbms-		
fourriers	fourrier	Ncbmp-		
fraiseur	fraiseur	Ncbms-		
fraiseurs	fraiseur	Ncbmp-		
franchiseur	franchiseur	Ncbms-		
franchiseurs	franchiseur	Ncbmp-		
franciscain	franciscain	Ncbms-		
franciscains	franciscain	Ncbmp-		
frappeur	frappeur	Ncbms-		
frappeurs	frappeur	Ncbmp-		
freineur	freineur	Ncbms-		
freineurs	freineur	Ncbmp-		
fresquiste	fresquiste	Ncbms-		
fresquistes	fresquiste	Ncbmp-		
frigoriste	frigoriste	Ncbms-		
frigoristes	frigoriste	Ncbmp-		
fripier	fripier	Ncbms-		
fripiers	fripier	Ncbmp-		
fromager	fromager	Ncbms-		
fromagers	fromager	Ncbmp-		
fumiste	fumiste	Ncbms-		
fumistes	fumiste	Ncbmp-		
funambule	funambule	Ncbms-		
funambules	funambule	Ncbmp-		
fusilier	fusilier	Ncbms-		
fusiliers	fusilier	Ncbmp-		
futurologue	futurologue	Ncbms-		
futurologues	futurologue	Ncbmp-		
gâcheur	gâcheur	Ncbms-		
gâcheurs	gâcheur	Ncbmp-		
gainier	gainier	Ncbms-		
gainiers	gainier	Ncbmp-		
galeriste	galeriste	Ncbms-		
galeristes	galeriste	Ncbmp-		
galvaniseur	galvaniseur	Ncbms-		
galvaniseurs	galvaniseur	Ncbmp-		
galvanoplaste	galvanoplaste	Ncbms-		
galvanoplastes	galvanoplaste	Ncbmp-		
gambiste	gambiste	Ncbms-		
gambistes	gambiste	Ncbmp-		
gamin	gamin	Ncbms-		
gamins	gamin	Ncbmp-		
gantier	gantier	Ncbms-		
gantiers	gantier	Ncbmp-		
garagiste	garagiste	Ncbms-		
garagistes	garagiste	Ncbmp-		
garçon	garçon	Ncbms-		
garçons	garçon	Ncbmp-		
garde	garde	Ncbms-		
gardes	garde	Ncbmp-		
garde d'enfants*	garde d'enfants*	Ncbms-		
garde d'enfants*s	garde d'enfants*	Ncbmp-		
gardian	gardian	Ncbms-		
gardians	gardian	Ncbmp-		
gardien	gardien	Ncbms-		
gardiens	gardien	Ncbmp-		
gareur	gareur	Ncbms-		
gareurs	gareur	Ncbmp-		
garnisseur	garnisseur	Ncbms-		
garnisseurs	garnisseur	Ncbmp-		
gastroentérologue	gastroentérologue	Ncbms-		
gastroentérologues	gastroentérologue	Ncbmp-		
gaufreur	gaufreur	Ncbms-		
gaufreurs	gaufreur	Ncbmp-		
gaveur	gaveur	Ncbms-		
gaveurs	gaveur	Ncbmp-		
gazier	gazier	Ncbms-		
gaziers	gazier	Ncbmp-		
gémellologue	gémellologue	Ncbms-		
gémellologues	gémellologue	Ncbmp-		
gemmeur	gemmeur	Ncbms-		
gemmeurs	gemmeur	Ncbmp-		
gemmologiste	gemmologiste	Ncbms-		
gemmologistes	gemmologiste	Ncbmp-		
gemmologue	gemmologue	Ncbms-		
gemmologues	gemmologue	Ncbmp-		
gendarme	gendarme	Ncbms-		
gendarmes	gendarme	Ncbmp-		
généalogiste	généalogiste	Ncbms-		
généalogistes	généalogiste	Ncbmp-		
général	général	Ncbms-		
générals	général	Ncbmp-		
généraliste	généraliste	Ncbms-		
généralistes	généraliste	Ncbmp-		
généticien	généticien	Ncbms-		
généticiens	généticien	Ncbmp-		
géochronologue	géochronologue	Ncbms-		
géochronologues	géochronologue	Ncbmp-		
géographe	géographe	Ncbms-		
géographes	géographe	Ncbmp-		
geôlier	geôlier	Ncbms-		
geôliers	geôlier	Ncbmp-		
géologue	géologue	Ncbms-		
géologues	géologue	Ncbmp-		
géomètre	géomètre	Ncbms-		
géomètres	géomètre	Ncbmp-		
géomorphologiste	géomorphologiste	Ncbms-		
géomorphologistes	géomorphologiste	Ncbmp-		
gérant	gérant	Ncbms-		
gérants	gérant	Ncbmp-		
gériatre	gériatre	Ncbms-		
gériatres	gériatre	Ncbmp-		
gérontologue	gérontologue	Ncbms-		
gérontologues	gérontologue	Ncbmp-		
gestionnaire	gestionnaire	Ncbms-		
gestionnaires	gestionnaire	Ncbmp-		
giletier	giletier	Ncbms-		
giletiers	giletier	Ncbmp-		
gitologue	gitologue	Ncbms-		
gitologues	gitologue	Ncbmp-		
glaceur	glaceur	Ncbms-		
glaceurs	glaceur	Ncbmp-		
glacielliste	glacielliste	Ncbms-		
glaciellistes	glacielliste	Ncbmp-		
glacier	glacier	Ncbms-		
glaciers	glacier	Ncbmp-		
glaciologue	glaciologue	Ncbms-		
glaciologues	glaciologue	Ncbmp-		
gnomoniste	gnomoniste	Ncbms-		
gnomonistes	gnomoniste	Ncbmp-		
goémonier	goémonier	Ncbms-		
goémoniers	goémonier	Ncbmp-		
golfeur	golfeur	Ncbms-		
golfeurs	golfeur	Ncbmp-		
gondolier	gondolier	Ncbms-		
gondoliers	gondolier	Ncbmp-		
gouacheur	gouacheur	Ncbms-		
gouacheurs	gouacheur	Ncbmp-		
goudronneur	goudronneur	Ncbms-		
goudronneurs	goudronneur	Ncbmp-		
gourou	gourou	Ncbms-		
gourous	gourou	Ncbmp-		
gouteur	gouteur	Ncbms-		
gouteurs	gouteur	Ncbmp-		
gouvernant	gouvernant	Ncbms-		
gouvernants	gouvernant	Ncbmp-		
gouverneur	gouverneur	Ncbms-		
gouverneurs	gouverneur	Ncbmp-		
gradeur	gradeur	Ncbms-		
gradeurs	gradeur	Ncbmp-		
gradueur	gradueur	Ncbms-		
gradueurs	gradueur	Ncbmp-		
grainetier	grainetier	Ncbms-		
grainetiers	grainetier	Ncbmp-		
grainier	grainier	Ncbms-		
grainiers	grainier	Ncbmp-		
graisseur	graisseur	Ncbms-		
graisseurs	graisseur	Ncbmp-		
grammairien	grammairien	Ncbms-		
grammairiens	grammairien	Ncbmp-		
granitiste	granitiste	Ncbms-		
granitistes	granitiste	Ncbmp-		
graphiste	graphiste	Ncbms-		
graphistes	graphiste	Ncbmp-		
graphologue	graphologue	Ncbms-		
graphologues	graphologue	Ncbmp-		
gratteur	gratteur	Ncbms-		
gratteurs	gratteur	Ncbmp-		
gravatier	gravatier	Ncbms-		
gravatiers	gravatier	Ncbmp-		
graveur	graveur	Ncbms-		
graveurs	graveur	Ncbmp-		
gravillonneur	gravillonneur	Ncbms-		
gravillonneurs	gravillonneur	Ncbmp-		
gréeur	gréeur	Ncbms-		
gréeurs	gréeur	Ncbmp-		
greffeur	greffeur	Ncbms-		
greffeurs	greffeur	Ncbmp-		
greffier	greffier	Ncbms-		
greffiers	greffier	Ncbmp-		
grenailleur	grenailleur	Ncbms-		
grenailleurs	grenailleur	Ncbmp-		
griffeur	griffeur	Ncbms-		
griffeurs	griffeur	Ncbmp-		
grignoteur	grignoteur	Ncbms-		
grignoteurs	grignoteur	Ncbmp-		
grillardin	grillardin	Ncbms-		
grillardins	grillardin	Ncbmp-		
grimpeur	grimpeur	Ncbms-		
grimpeurs	grimpeur	Ncbmp-		
groom	groom	Ncbms-		
grooms	groom	Ncbmp-		
grossiste	grossiste	Ncbms-		
grossistes	grossiste	Ncbmp-		
groupiste	groupiste	Ncbms-		
groupistes	groupiste	Ncbmp-		
grutier	grutier	Ncbms-		
grutiers	grutier	Ncbmp-		
guérisseur	guérisseur	Ncbms-		
guérisseurs	guérisseur	Ncbmp-		
guichetier	guichetier	Ncbms-		
guichetiers	guichetier	Ncbmp-		
guide	guide	Ncbms-		
guides	guide	Ncbmp-		
guillocheur	guillocheur	Ncbms-		
guillocheurs	guillocheur	Ncbmp-		
guillotineur*	guillotineur*	Ncbms-		
guillotineur*s	guillotineur*	Ncbmp-		
guimpier	guimpier	Ncbms-		
guimpiers	guimpier	Ncbmp-		
guipurier	guipurier	Ncbms-		
guipuriers	guipurier	Ncbmp-		
guitariste	guitariste	Ncbms-		
guitaristes	guitariste	Ncbmp-		
guniteur	guniteur	Ncbms-		
guniteurs	guniteur	Ncbmp-		
gutteur	gutteur	Ncbms-		
gutteurs	gutteur	Ncbmp-		
gymnaste	gymnaste	Ncbms-		
gymnastes	gymnaste	Ncbmp-		
gynécologue	gynécologue	Ncbms-		
gynécologues	gynécologue	Ncbmp-		
habilleur	habilleur	Ncbms-		
habilleurs	habilleur	Ncbmp-		
hacheur	hacheur	Ncbms-		
hacheurs	hacheur	Ncbmp-		
hagiographe	hagiographe	Ncbms-		
hagiographes	hagiographe	Ncbmp-		
halieute	halieute	Ncbms-		
halieutes	halieute	Ncbmp-		
haltérophile	haltérophile	Ncbms-		
haltérophiles	haltérophile	Ncbmp-		
handballeur	handballeur	Ncbms-		
handballeurs	handballeur	Ncbmp-		
harpiste	harpiste	Ncbms-		
harpistes	harpiste	Ncbmp-		
haut	haut	Ncbms-		
hauts	haut	Ncbmp-		
hautboïste	hautboïste	Ncbms-		
hautboïstes	hautboïste	Ncbmp-		
héliciculteur	héliciculteur	Ncbms-		
héliciculteurs	héliciculteur	Ncbmp-		
hélicoptériste	hélicoptériste	Ncbms-		
hélicoptéristes	hélicoptériste	Ncbmp-		
hématologiste	hématologiste	Ncbms-		
hématologistes	hématologiste	Ncbmp-		
hématologue	hématologue	Ncbms-		
hématologues	hématologue	Ncbmp-		
hépatologue	hépatologue	Ncbms-		
hépatologues	hépatologue	Ncbmp-		
héraldiste	héraldiste	Ncbms-		
héraldistes	héraldiste	Ncbmp-		
herbager	herbager	Ncbms-		
herbagers	herbager	Ncbmp-		
herboriste	herboriste	Ncbms-		
herboristes	herboriste	Ncbmp-		
hercheur	hercheur	Ncbms-		
hercheurs	hercheur	Ncbmp-		
herscheur	herscheur	Ncbms-		
herscheurs	herscheur	Ncbmp-		
histologiste	histologiste	Ncbms-		
histologistes	histologiste	Ncbmp-		
historien	historien	Ncbms-		
historiens	historien	Ncbmp-		
historiographe	historiographe	Ncbms-		
historiographes	historiographe	Ncbmp-		
hockeyeur	hockeyeur	Ncbms-		
hockeyeurs	hockeyeur	Ncbmp-		
homéopathe	homéopathe	Ncbms-		
homéopathes	homéopathe	Ncbmp-		
homme	homme	Ncbms-		
hommes	homme	Ncbmp-		
hongroyeur	hongroyeur	Ncbms-		
hongroyeurs	hongroyeur	Ncbmp-		
horloger	horloger	Ncbms-		
horlogers	horloger	Ncbmp-		
horticulteur	horticulteur	Ncbms-		
horticulteurs	horticulteur	Ncbmp-		
hospitalier	hospitalier	Ncbms-		
hospitaliers	hospitalier	Ncbmp-		
hôte	hôte	Ncbms-		
hôtes	hôte	Ncbmp-		
hôtelier	hôtelier	Ncbms-		
hôteliers	hôtelier	Ncbmp-		
houblonnier	houblonnier	Ncbms-		
houblonniers	houblonnier	Ncbmp-		
huileur	huileur	Ncbms-		
huileurs	huileur	Ncbmp-		
huilier	huilier	Ncbms-		
huiliers	huilier	Ncbmp-		
huissier	huissier	Ncbms-		
huissiers	huissier	Ncbmp-		
huitrier	huitrier	Ncbms-		
huitriers	huitrier	Ncbmp-		
humoriste	humoriste	Ncbms-		
humoristes	humoriste	Ncbmp-		
hydraulicien	hydraulicien	Ncbms-		
hydrauliciens	hydraulicien	Ncbmp-		
hydrobiologiste	hydrobiologiste	Ncbms-		
hydrobiologistes	hydrobiologiste	Ncbmp-		
hydrodynamicien	hydrodynamicien	Ncbms-		
hydrodynamiciens	hydrodynamicien	Ncbmp-		
hydrographe	hydrographe	Ncbms-		
hydrographes	hydrographe	Ncbmp-		
hydrologue	hydrologue	Ncbms-		
hydrologues	hydrologue	Ncbmp-		
hygiéniste	hygiéniste	Ncbms-		
hygiénistes	hygiéniste	Ncbmp-		
hypnotiseur	hypnotiseur	Ncbms-		
hypnotiseurs	hypnotiseur	Ncbmp-		
ichtyologiste	ichtyologiste	Ncbms-		
ichtyologistes	ichtyologiste	Ncbmp-		
ichtyologue	ichtyologue	Ncbms-		
ichtyologues	ichtyologue	Ncbmp-		
iconographe	iconographe	Ncbms-		
iconographes	iconographe	Ncbmp-		
identificateur	identificateur	Ncbms-		
identificateurs	identificateur	Ncbmp-		
idéologue	idéologue	Ncbms-		
idéologues	idéologue	Ncbmp-		
illuminateur	illuminateur	Ncbms-		
illuminateurs	illuminateur	Ncbmp-		
illusionniste	illusionniste	Ncbms-		
illusionnistes	illusionniste	Ncbmp-		
illustrateur	illustrateur	Ncbms-		
illustrateurs	illustrateur	Ncbmp-		
ilotier	ilotier	Ncbms-		
ilotiers	ilotier	Ncbmp-		
imbricateur	imbricateur	Ncbms-		
imbricateurs	imbricateur	Ncbmp-		
imitateur	imitateur	Ncbms-		
imitateurs	imitateur	Ncbmp-		
immunologue	immunologue	Ncbms-		
immunologues	immunologue	Ncbmp-		
implanteur	implanteur	Ncbms-		
implanteurs	implanteur	Ncbmp-		
importateur	importateur	Ncbms-		
importateurs	importateur	Ncbmp-		
imposeur	imposeur	Ncbms-		
imposeurs	imposeur	Ncbmp-		
imprésario	imprésario	Ncbms-		
imprésarios	imprésario	Ncbmp-		
imprimeur	imprimeur	Ncbms-		
imprimeurs	imprimeur	Ncbmp-		
incorporateur	incorporateur	Ncbms-		
incorporateurs	incorporateur	Ncbmp-		
incrustateur	incrustateur	Ncbms-		
incrustateurs	incrustateur	Ncbmp-		
indicateur	indicateur	Ncbms-		
indicateurs	indicateur	Ncbmp-		
industriel	industriel	Ncbms-		
industriels	industriel	Ncbmp-		
infirmier	infirmier	Ncbms-		
infirmiers	infirmier	Ncbmp-		
infographe	infographe	Ncbms-		
infographes	infographe	Ncbmp-		
infographiste	infographiste	Ncbms-		
infographistes	infographiste	Ncbmp-		
informateur	informateur	Ncbms-		
informateurs	informateur	Ncbmp-		
informaticien	informaticien	Ncbms-		
informaticiens	informaticien	Ncbmp-		
infrarougiste	infrarougiste	Ncbms-		
infrarougistes	infrarougiste	Ncbmp-		
ingénieur	ingénieur	Ncbms-		
ingénieurs	ingénieur	Ncbmp-		
initiateur	initiateur	Ncbms-		
initiateurs	initiateur	Ncbmp-		
injecteur	injecteur	Ncbms-		
injecteurs	injecteur	Ncbmp-		
inséminateur	inséminateur	Ncbms-		
inséminateurs	inséminateur	Ncbmp-		
inspecteur	inspecteur	Ncbms-		
inspecteurs	inspecteur	Ncbmp-		
installateur	installateur	Ncbms-		
installateurs	installateur	Ncbmp-		
instituteur	instituteur	Ncbms-		
instituteurs	instituteur	Ncbmp-		
instructeur	instructeur	Ncbms-		
instructeurs	instructeur	Ncbmp-		
instrumentiste	instrumentiste	Ncbms-		
instrumentistes	instrumentiste	Ncbmp-		
intellectuel	intellectuel	Ncbms-		
intellectuels	intellectuel	Ncbmp-		
intendant	intendant	Ncbms-		
intendants	intendant	Ncbmp-		
intérimaire	intérimaire	Ncbms-		
intérimaires	intérimaire	Ncbmp-		
interlocuteur	interlocuteur	Ncbms-		
interlocuteurs	interlocuteur	Ncbmp-		
intermédiaire	intermédiaire	Ncbms-		
intermédiaires	intermédiaire	Ncbmp-		
intermittent	intermittent	Ncbms-		
intermittents	intermittent	Ncbmp-		
interne	interne	Ncbms-		
internes	interne	Ncbmp-		
interniste	interniste	Ncbms-		
internistes	interniste	Ncbmp-		
interprète	interprète	Ncbms-		
interprètes	interprète	Ncbmp-		
interrogateur	interrogateur	Ncbms-		
interrogateurs	interrogateur	Ncbmp-		
intervalliste	intervalliste	Ncbms-		
intervallistes	intervalliste	Ncbmp-		
intervenant	intervenant	Ncbms-		
intervenants	intervenant	Ncbmp-		
intervieweur	intervieweur	Ncbms-		
intervieweurs	intervieweur	Ncbmp-		
inventeur	inventeur	Ncbms-		
inventeurs	inventeur	Ncbmp-		
investisseur	investisseur	Ncbms-		
investisseurs	investisseur	Ncbmp-		
iridologue	iridologue	Ncbms-		
iridologues	iridologue	Ncbmp-		
irrigateur	irrigateur	Ncbms-		
irrigateurs	irrigateur	Ncbmp-		
isolateur	isolateur	Ncbms-		
isolateurs	isolateur	Ncbmp-		
ivoirier	ivoirier	Ncbms-		
ivoiriers	ivoirier	Ncbmp-		
jardinier	jardinier	Ncbms-		
jardiniers	jardinier	Ncbmp-		
jardinier d'enfants*	jardinier d'enfants*	Ncbms-		
jardinier d'enfants*s	jardinier d'enfants*	Ncbmp-		
jaugeur	jaugeur	Ncbms-		
jaugeurs	jaugeur	Ncbmp-		
joailler	joailler	Ncbms-		
joaillers	joailler	Ncbmp-		
jockey	jockey	Ncbms-		
jockeys	jockey	Ncbmp-		
jointeur	jointeur	Ncbms-		
jointeurs	jointeur	Ncbmp-		
jointoyeur	jointoyeur	Ncbms-		
jointoyeurs	jointoyeur	Ncbmp-		
jongleur	jongleur	Ncbms-		
jongleurs	jongleur	Ncbmp-		
joueur	joueur	Ncbms-		
joueurs	joueur	Ncbmp-		
journalier	journalier	Ncbms-		
journaliers	journalier	Ncbmp-		
journaliste	journaliste	Ncbms-		
journalistes	journaliste	Ncbmp-		
judoka	judoka	Ncbms-		
judokas	judoka	Ncbmp-		
juge	juge	Ncbms-		
juges	juge	Ncbmp-		
junior	junior	Ncbms-		
juniors	junior	Ncbmp-		
juré	juré	Ncbms-		
jurés	juré	Ncbmp-		
jurisconsulte	jurisconsulte	Ncbms-		
jurisconsultes	jurisconsulte	Ncbmp-		
juriste	juriste	Ncbms-		
juristes	juriste	Ncbmp-		
juristicien	juristicien	Ncbms-		
juristiciens	juristicien	Ncbmp-		
karatéka	karatéka	Ncbms-		
karatékas	karatéka	Ncbmp-		
kayakiste	kayakiste	Ncbms-		
kayakistes	kayakiste	Ncbmp-		
képissier	képissier	Ncbms-		
képissiers	képissier	Ncbmp-		
kinésithérapeute	kinésithérapeute	Ncbms-		
kinésithérapeutes	kinésithérapeute	Ncbmp-		
kiosquaire	kiosquaire	Ncbms-		
kiosquaires	kiosquaire	Ncbmp-		
kiwiculteur	kiwiculteur	Ncbms-		
kiwiculteurs	kiwiculteur	Ncbmp-		
koriste	koriste	Ncbms-		
koristes	koriste	Ncbmp-		
laborant	laborant	Ncbms-		
laborants	laborant	Ncbmp-		
laborantin	laborantin	Ncbms-		
laborantins	laborantin	Ncbmp-		
laboriste	laboriste	Ncbms-		
laboristes	laboriste	Ncbmp-		
lad	lad	Ncbms-		
lads	lad	Ncbmp-		
lainier	lainier	Ncbms-		
lainiers	lainier	Ncbmp-		
laitier	laitier	Ncbms-		
laitiers	laitier	Ncbmp-		
lamaneur	lamaneur	Ncbms-		
lamaneurs	lamaneur	Ncbmp-		
lamineur	lamineur	Ncbms-		
lamineurs	lamineur	Ncbmp-		
lanceur	lanceur	Ncbms-		
lanceurs	lanceur	Ncbmp-		
lancier	lancier	Ncbms-		
lanciers	lancier	Ncbmp-		
lanternier	lanternier	Ncbms-		
lanterniers	lanternier	Ncbmp-		
lapidaire	lapidaire	Ncbms-		
lapidaires	lapidaire	Ncbmp-		
laqueur	laqueur	Ncbms-		
laqueurs	laqueur	Ncbmp-		
largueur	largueur	Ncbms-		
largueurs	largueur	Ncbmp-		
laryngologiste	laryngologiste	Ncbms-		
laryngologistes	laryngologiste	Ncbmp-		
lavandiculteur	lavandiculteur	Ncbms-		
lavandiculteurs	lavandiculteur	Ncbmp-		
lavandier	lavandier	Ncbms-		
lavandiers	lavandier	Ncbmp-		
laveur	laveur	Ncbms-		
laveurs	laveur	Ncbmp-		
layetier	layetier	Ncbms-		
layetiers	layetier	Ncbmp-		
lecteur	lecteur	Ncbms-		
lecteurs	lecteur	Ncbmp-		
légionnaire*	légionnaire*	Ncbms-		
légionnaire*s	légionnaire*	Ncbmp-		
législateur	législateur	Ncbms-		
législateurs	législateur	Ncbmp-		
légiste	légiste	Ncbms-		
légistes	légiste	Ncbmp-		
légumier	légumier	Ncbms-		
légumiers	légumier	Ncbmp-		
lépidoptériste	lépidoptériste	Ncbms-		
lépidoptéristes	lépidoptériste	Ncbmp-		
lessiveur	lessiveur	Ncbms-		
lessiveurs	lessiveur	Ncbmp-		
lettreur	lettreur	Ncbms-		
lettreurs	lettreur	Ncbmp-		
levageur	levageur	Ncbms-		
levageurs	levageur	Ncbmp-		
leveur	leveur	Ncbms-		
leveurs	leveur	Ncbmp-		
lexicographe	lexicographe	Ncbms-		
lexicographes	lexicographe	Ncbmp-		
lexicologue	lexicologue	Ncbms-		
lexicologues	lexicologue	Ncbmp-		
libelliste	libelliste	Ncbms-		
libellistes	libelliste	Ncbmp-		
libériste	libériste	Ncbms-		
libéristes	libériste	Ncbmp-		
libraire	libraire	Ncbms-		
libraires	libraire	Ncbmp-		
librettiste	librettiste	Ncbms-		
librettistes	librettiste	Ncbmp-		
licencié	licencié	Ncbms-		
licenciés	licencié	Ncbmp-		
licier	licier	Ncbms-		
liciers	licier	Ncbmp-		
liégeur	liégeur	Ncbms-		
liégeurs	liégeur	Ncbmp-		
liégiste	liégiste	Ncbms-		
liégistes	liégiste	Ncbmp-		
lieutenant	lieutenant	Ncbms-		
lieutenants	lieutenant	Ncbmp-		
liftier	liftier	Ncbms-		
liftiers	liftier	Ncbmp-		
lignard	lignard	Ncbms-		
lignards	lignard	Ncbmp-		
ligneur	ligneur	Ncbms-		
ligneurs	ligneur	Ncbmp-		
limonadier	limonadier	Ncbms-		
limonadiers	limonadier	Ncbmp-		
limousinant	limousinant	Ncbms-		
limousinants	limousinant	Ncbmp-		
linger	linger	Ncbms-		
lingers	linger	Ncbmp-		
linguiste	linguiste	Ncbms-		
linguistes	linguiste	Ncbmp-		
linotypiste	linotypiste	Ncbms-		
linotypistes	linotypiste	Ncbmp-		
liquidateur	liquidateur	Ncbms-		
liquidateurs	liquidateur	Ncbmp-		
liquoriste	liquoriste	Ncbms-		
liquoristes	liquoriste	Ncbmp-		
liseur	liseur	Ncbms-		
liseurs	liseur	Ncbmp-		
lisseur	lisseur	Ncbms-		
lisseurs	lisseur	Ncbmp-		
lithographe	lithographe	Ncbms-		
lithographes	lithographe	Ncbmp-		
litigeur	litigeur	Ncbms-		
litigeurs	litigeur	Ncbmp-		
littérateur	littérateur	Ncbms-		
littérateurs	littérateur	Ncbmp-		
livrancier	livrancier	Ncbms-		
livranciers	livrancier	Ncbmp-		
livreur	livreur	Ncbms-		
livreurs	livreur	Ncbmp-		
logisticien	logisticien	Ncbms-		
logisticiens	logisticien	Ncbmp-		
logopède	logopède	Ncbms-		
logopèdes	logopède	Ncbmp-		
lombriculteur	lombriculteur	Ncbms-		
lombriculteurs	lombriculteur	Ncbmp-		
lotisseur	lotisseur	Ncbms-		
lotisseurs	lotisseur	Ncbmp-		
loueur	loueur	Ncbms-		
loueurs	loueur	Ncbmp-		
ludothécaire	ludothécaire	Ncbms-		
ludothécaires	ludothécaire	Ncbmp-		
lunetier	lunetier	Ncbms-		
lunetiers	lunetier	Ncbmp-		
lunetteur	lunetteur	Ncbms-		
lunetteurs	lunetteur	Ncbmp-		
luthier	luthier	Ncbms-		
luthiers	luthier	Ncbmp-		
luthiste	luthiste	Ncbms-		
luthistes	luthiste	Ncbmp-		
lutteur	lutteur	Ncbms-		
lutteurs	lutteur	Ncbmp-		
machiniste	machiniste	Ncbms-		
machinistes	machiniste	Ncbmp-		
maçon	maçon	Ncbms-		
maçons	maçon	Ncbmp-		
magasinier	magasinier	Ncbms-		
magasiniers	magasinier	Ncbmp-		
mage	mage	Ncbms-		
mages	mage	Ncbmp-		
magicien	magicien	Ncbms-		
magiciens	magicien	Ncbmp-		
magistrat	magistrat	Ncbms-		
magistrats	magistrat	Ncbmp-		
magmatologue	magmatologue	Ncbms-		
magmatologues	magmatologue	Ncbmp-		
maïeuticien [informatique]	maïeuticien [informatique]	Ncbms-		
maïeuticien [informatique]s	maïeuticien [informatique]	Ncbmp-		
maïeuticien* [médecine]	maïeuticien* [médecine]	Ncbms-		
maïeuticien* [médecine]s	maïeuticien* [médecine]	Ncbmp-		
maillocheur	maillocheur	Ncbms-		
maillocheurs	maillocheur	Ncbmp-		
main courantier	main courantier	Ncbms-		
main courantiers	main courantier	Ncbmp-		
maintenicien	maintenicien	Ncbms-		
mainteniciens	maintenicien	Ncbmp-		
maire	maire	Ncbms-		
maires	maire	Ncbmp-		
maïsiculteur	maïsiculteur	Ncbms-		
maïsiculteurs	maïsiculteur	Ncbmp-		
maitre	maitre	Ncbms-		
maitres	maitre	Ncbmp-		
major	major	Ncbms-		
majors	major	Ncbmp-		
majordome	majordome	Ncbms-		
majordomes	majordome	Ncbmp-		
malacologue	malacologue	Ncbms-		
malacologues	malacologue	Ncbmp-		
malaxeur	malaxeur	Ncbms-		
malaxeurs	malaxeur	Ncbmp-		
malletier	malletier	Ncbms-		
malletiers	malletier	Ncbmp-		
malteur	malteur	Ncbms-		
malteurs	malteur	Ncbmp-		
manadier	manadier	Ncbms-		
manadiers	manadier	Ncbmp-		
manageur*	manageur*	Ncbms-		
manageur*s	manageur*	Ncbmp-		
manchonnier	manchonnier	Ncbms-		
manchonniers	manchonnier	Ncbmp-		
mandataire	mandataire	Ncbms-		
mandataires	mandataire	Ncbmp-		
manipulateur	manipulateur	Ncbms-		
manipulateurs	manipulateur	Ncbmp-		
mannequin	mannequin	Ncbms-		
mannequins	mannequin	Ncbmp-		
manouvre	manouvre	Ncbms-		
manouvres	manouvre	Ncbmp-		
manouvrier	manouvrier	Ncbms-		
manouvriers	manouvrier	Ncbmp-		
manucure	manucure	Ncbms-		
manucures	manucure	Ncbmp-		
manutentionnaire	manutentionnaire	Ncbms-		
manutentionnaires	manutentionnaire	Ncbmp-		
maquettiste	maquettiste	Ncbms-		
maquettistes	maquettiste	Ncbmp-		
maquignon	maquignon	Ncbms-		
maquignons	maquignon	Ncbmp-		
maquilleur	maquilleur	Ncbms-		
maquilleurs	maquilleur	Ncbmp-		
maraicher	maraicher	Ncbms-		
maraichers	maraicher	Ncbmp-		
marathonien	marathonien	Ncbms-		
marathoniens	marathonien	Ncbmp-		
marbreur	marbreur	Ncbms-		
marbreurs	marbreur	Ncbmp-		
marbrier	marbrier	Ncbms-		
marbriers	marbrier	Ncbmp-		
marchand	marchand	Ncbms-		
marchands	marchand	Ncbmp-		
marchandiseur	marchandiseur	Ncbms-		
marchandiseurs	marchandiseur	Ncbmp-		
maréchal	maréchal	Ncbms-		
maréchals	maréchal	Ncbmp-		
maréchal-ferrant	maréchal-ferrant	Ncbms-		
maréchal-ferrants	maréchal-ferrant	Ncbmp-		
margeur	margeur	Ncbms-		
margeurs	margeur	Ncbmp-		
marguillier	marguillier	Ncbms-		
marguilliers	marguillier	Ncbmp-		
mariculteur	mariculteur	Ncbms-		
mariculteurs	mariculteur	Ncbmp-		
marin	marin	Ncbms-		
marins	marin	Ncbmp-		
marinier	marinier	Ncbms-		
mariniers	marinier	Ncbmp-		
marionnettiste	marionnettiste	Ncbms-		
marionnettistes	marionnettiste	Ncbmp-		
marmiton	marmiton	Ncbms-		
marmitons	marmiton	Ncbmp-		
maroquinier	maroquinier	Ncbms-		
maroquiniers	maroquinier	Ncbmp-		
marqueteur	marqueteur	Ncbms-		
marqueteurs	marqueteur	Ncbmp-		
marqueur	marqueur	Ncbms-		
marqueurs	marqueur	Ncbmp-		
marquis	marquis	Ncbms-		
marquiss	marquis	Ncbmp-		
marteleur	marteleur	Ncbms-		
marteleurs	marteleur	Ncbmp-		
martineur	martineur	Ncbms-		
martineurs	martineur	Ncbmp-		
masselotteur	masselotteur	Ncbms-		
masselotteurs	masselotteur	Ncbmp-		
masseur	masseur	Ncbms-		
masseurs	masseur	Ncbmp-		
massicoteur	massicoteur	Ncbms-		
massicoteurs	massicoteur	Ncbmp-		
massicotier	massicotier	Ncbms-		
massicotiers	massicotier	Ncbmp-		
mastiqueur	mastiqueur	Ncbms-		
mastiqueurs	mastiqueur	Ncbmp-		
mastologue	mastologue	Ncbms-		
mastologues	mastologue	Ncbmp-		
matelasseur	matelasseur	Ncbms-		
matelasseurs	matelasseur	Ncbmp-		
matelassier	matelassier	Ncbms-		
matelassiers	matelassier	Ncbmp-		
matelot	matelot	Ncbms-		
matelots	matelot	Ncbmp-		
mateur	mateur	Ncbms-		
mateurs	mateur	Ncbmp-		
mathématicien	mathématicien	Ncbms-		
mathématiciens	mathématicien	Ncbmp-		
matriceur	matriceur	Ncbms-		
matriceurs	matriceur	Ncbmp-		
mécanicien	mécanicien	Ncbms-		
mécaniciens	mécanicien	Ncbmp-		
mécanographe	mécanographe	Ncbms-		
mécanographes	mécanographe	Ncbmp-		
mécatronicien	mécatronicien	Ncbms-		
mécatroniciens	mécatronicien	Ncbmp-		
médailleur	médailleur	Ncbms-		
médailleurs	médailleur	Ncbmp-		
médecin	médecin	Ncbms-		
médecins	médecin	Ncbmp-		
médialogue	médialogue	Ncbms-		
médialogues	médialogue	Ncbmp-		
média-planneur	média-planneur	Ncbms-		
média-planneurs	média-planneur	Ncbmp-		
médiateur	médiateur	Ncbms-		
médiateurs	médiateur	Ncbmp-		
mégissier	mégissier	Ncbms-		
mégissiers	mégissier	Ncbmp-		
mélangeur	mélangeur	Ncbms-		
mélangeurs	mélangeur	Ncbmp-		
mémorialiste	mémorialiste	Ncbms-		
mémorialistes	mémorialiste	Ncbmp-		
meneur	meneur	Ncbms-		
meneurs	meneur	Ncbmp-		
menuisier	menuisier	Ncbms-		
menuisiers	menuisier	Ncbmp-		
mercaticien	mercaticien	Ncbms-		
mercaticiens	mercaticien	Ncbmp-		
merceriseur	merceriseur	Ncbms-		
merceriseurs	merceriseur	Ncbmp-		
merchandiseur	merchandiseur	Ncbms-		
merchandiseurs	merchandiseur	Ncbmp-		
mercier	mercier	Ncbms-		
merciers	mercier	Ncbmp-		
mésomorphiste	mésomorphiste	Ncbms-		
mésomorphistes	mésomorphiste	Ncbmp-		
mesureur	mesureur	Ncbms-		
mesureurs	mesureur	Ncbmp-		
métallier	métallier	Ncbms-		
métalliers	métallier	Ncbmp-		
métalliseur	métalliseur	Ncbms-		
métalliseurs	métalliseur	Ncbmp-		
métallogéniste	métallogéniste	Ncbms-		
métallogénistes	métallogéniste	Ncbmp-		
métallographe	métallographe	Ncbms-		
métallographes	métallographe	Ncbmp-		
métallurgiste	métallurgiste	Ncbms-		
métallurgistes	métallurgiste	Ncbmp-		
métayer	métayer	Ncbms-		
métayers	métayer	Ncbmp-		
météorologiste	météorologiste	Ncbms-		
météorologistes	météorologiste	Ncbmp-		
météorologue	météorologue	Ncbms-		
météorologues	météorologue	Ncbmp-		
métreur	métreur	Ncbms-		
métreurs	métreur	Ncbmp-		
métrologiste	métrologiste	Ncbms-		
métrologistes	métrologiste	Ncbmp-		
métrologue	métrologue	Ncbms-		
métrologues	métrologue	Ncbmp-		
metteur	metteur	Ncbms-		
metteurs	metteur	Ncbmp-		
meuleur	meuleur	Ncbms-		
meuleurs	meuleur	Ncbmp-		
meunier	meunier	Ncbms-		
meuniers	meunier	Ncbmp-		
militaire	militaire	Ncbms-		
militaires	militaire	Ncbmp-		
mime	mime	Ncbms-		
mimes	mime	Ncbmp-		
minérallurgiste	minérallurgiste	Ncbms-		
minérallurgistes	minérallurgiste	Ncbmp-		
minéralogiste	minéralogiste	Ncbms-		
minéralogistes	minéralogiste	Ncbmp-		
mineur	mineur	Ncbms-		
mineurs	mineur	Ncbmp-		
miniaturiste	miniaturiste	Ncbms-		
miniaturistes	miniaturiste	Ncbmp-		
minime	minime	Ncbms-		
minimes	minime	Ncbmp-		
ministre	ministre	Ncbms-		
ministres	ministre	Ncbmp-		
mireur	mireur	Ncbms-		
mireurs	mireur	Ncbmp-		
miroitier	miroitier	Ncbms-		
miroitiers	miroitier	Ncbmp-		
missilier	missilier	Ncbms-		
missiliers	missilier	Ncbmp-		
missionnaire	missionnaire	Ncbms-		
missionnaires	missionnaire	Ncbmp-		
mitronnier	mitronnier	Ncbms-		
mitronniers	mitronnier	Ncbmp-		
mixeur	mixeur	Ncbms-		
mixeurs	mixeur	Ncbmp-		
modèle	modèle	Ncbms-		
modèles	modèle	Ncbmp-		
modeleur	modeleur	Ncbms-		
modeleurs	modeleur	Ncbmp-		
modélisateur	modélisateur	Ncbms-		
modélisateurs	modélisateur	Ncbmp-		
modéliste	modéliste	Ncbms-		
modélistes	modéliste	Ncbmp-		
modiste	modiste	Ncbms-		
modistes	modiste	Ncbmp-		
moellonneur	moellonneur	Ncbms-		
moellonneurs	moellonneur	Ncbmp-		
moine	moine	Ncbms-		
moines	moine	Ncbmp-		
moireur	moireur	Ncbms-		
moireurs	moireur	Ncbmp-		
monétariste	monétariste	Ncbms-		
monétaristes	monétariste	Ncbmp-		
moniteur	moniteur	Ncbms-		
moniteurs	moniteur	Ncbmp-		
monotypiste	monotypiste	Ncbms-		
monotypistes	monotypiste	Ncbmp-		
monsieur de compagnie*	monsieur de compagnie*	Ncbms-		
monsieur de compagnie*s	monsieur de compagnie*	Ncbmp-		
monteur	monteur	Ncbms-		
monteurs	monteur	Ncbmp-		
moquettiste	moquettiste	Ncbms-		
moquettistes	moquettiste	Ncbmp-		
mortaiseur	mortaiseur	Ncbms-		
mortaiseurs	mortaiseur	Ncbmp-		
mosaïqueur	mosaïqueur	Ncbms-		
mosaïqueurs	mosaïqueur	Ncbmp-		
mosaïste	mosaïste	Ncbms-		
mosaïstes	mosaïste	Ncbmp-		
motard	motard	Ncbms-		
motards	motard	Ncbmp-		
motociste	motociste	Ncbms-		
motocistes	motociste	Ncbmp-		
motoriste	motoriste	Ncbms-		
motoristes	motoriste	Ncbmp-		
moufletier	moufletier	Ncbms-		
moufletiers	moufletier	Ncbmp-		
mouleur	mouleur	Ncbms-		
mouleurs	mouleur	Ncbmp-		
moulineur	moulineur	Ncbms-		
moulineurs	moulineur	Ncbmp-		
moulinier	moulinier	Ncbms-		
mouliniers	moulinier	Ncbmp-		
mouliste	mouliste	Ncbms-		
moulistes	mouliste	Ncbmp-		
mousse	mousse	Ncbms-		
mousses	mousse	Ncbmp-		
moutonnier	moutonnier	Ncbms-		
moutonniers	moutonnier	Ncbmp-		
musicien	musicien	Ncbms-		
musiciens	musicien	Ncbmp-		
musicologue	musicologue	Ncbms-		
musicologues	musicologue	Ncbmp-		
mycologue	mycologue	Ncbms-		
mycologues	mycologue	Ncbmp-		
mytiliculteur	mytiliculteur	Ncbms-		
mytiliculteurs	mytiliculteur	Ncbmp-		
nacellier	nacellier	Ncbms-		
nacelliers	nacellier	Ncbmp-		
nacreur	nacreur	Ncbms-		
nacreurs	nacreur	Ncbmp-		
nageur	nageur	Ncbms-		
nageurs	nageur	Ncbmp-		
naisseur	naisseur	Ncbms-		
naisseurs	naisseur	Ncbmp-		
nappeur	nappeur	Ncbms-		
nappeurs	nappeur	Ncbmp-		
narrateur	narrateur	Ncbms-		
narrateurs	narrateur	Ncbmp-		
naturaliste	naturaliste	Ncbms-		
naturalistes	naturaliste	Ncbmp-		
naturopathe	naturopathe	Ncbms-		
naturopathes	naturopathe	Ncbmp-		
naturopraticien	naturopraticien	Ncbms-		
naturopraticiens	naturopraticien	Ncbmp-		
navigateur	navigateur	Ncbms-		
navigateurs	navigateur	Ncbmp-		
nécromancien	nécromancien	Ncbms-		
nécromanciens	nécromancien	Ncbmp-		
négociant	négociant	Ncbms-		
négociants	négociant	Ncbmp-		
négociateur	négociateur	Ncbms-		
négociateurs	négociateur	Ncbmp-		
néphrologue	néphrologue	Ncbms-		
néphrologues	néphrologue	Ncbmp-		
nettoyeur	nettoyeur	Ncbms-		
nettoyeurs	nettoyeur	Ncbmp-		
neurologue	neurologue	Ncbms-		
neurologues	neurologue	Ncbmp-		
neutronicien	neutronicien	Ncbms-		
neutroniciens	neutronicien	Ncbmp-		
nickeleur	nickeleur	Ncbms-		
nickeleurs	nickeleur	Ncbmp-		
nitrureur	nitrureur	Ncbms-		
nitrureurs	nitrureur	Ncbmp-		
nivologue	nivologue	Ncbms-		
nivologues	nivologue	Ncbmp-		
nomenclaturiste	nomenclaturiste	Ncbms-		
nomenclaturistes	nomenclaturiste	Ncbmp-		
normalien	normalien	Ncbms-		
normaliens	normalien	Ncbmp-		
notaire	notaire	Ncbms-		
notaires	notaire	Ncbmp-		
notateur	notateur	Ncbms-		
notateurs	notateur	Ncbmp-		
noueur	noueur	Ncbms-		
noueurs	noueur	Ncbmp-		
nouvelliste	nouvelliste	Ncbms-		
nouvellistes	nouvelliste	Ncbmp-		
novice	novice	Ncbms-		
novices	novice	Ncbmp-		
noyauteur	noyauteur	Ncbms-		
noyauteurs	noyauteur	Ncbmp-		
numismate	numismate	Ncbms-		
numismates	numismate	Ncbmp-		
nutritionniste	nutritionniste	Ncbms-		
nutritionnistes	nutritionniste	Ncbmp-		
oblat	oblat	Ncbms-		
oblats	oblat	Ncbmp-		
observateur	observateur	Ncbms-		
observateurs	observateur	Ncbmp-		
obstétricien	obstétricien	Ncbms-		
obstétriciens	obstétricien	Ncbmp-		
obtenteur	obtenteur	Ncbms-		
obtenteurs	obtenteur	Ncbmp-		
océaniste	océaniste	Ncbms-		
océanistes	océaniste	Ncbmp-		
océanographe	océanographe	Ncbms-		
océanographes	océanographe	Ncbmp-		
océanologue	océanologue	Ncbms-		
océanologues	océanologue	Ncbmp-		
oculariste	oculariste	Ncbms-		
ocularistes	oculariste	Ncbmp-		
oculiste	oculiste	Ncbms-		
oculistes	oculiste	Ncbmp-		
odontologiste	odontologiste	Ncbms-		
odontologistes	odontologiste	Ncbmp-		
odontologue	odontologue	Ncbms-		
odontologues	odontologue	Ncbmp-		
officiel	officiel	Ncbms-		
officiels	officiel	Ncbmp-		
officier	officier	Ncbms-		
officiers	officier	Ncbmp-		
officinal	officinal	Ncbms-		
officinals	officinal	Ncbmp-		
offsettiste	offsettiste	Ncbms-		
offsettistes	offsettiste	Ncbmp-		
oiseleur	oiseleur	Ncbms-		
oiseleurs	oiseleur	Ncbmp-		
oiselier	oiselier	Ncbms-		
oiseliers	oiselier	Ncbmp-		
oléiculteur	oléiculteur	Ncbms-		
oléiculteurs	oléiculteur	Ncbmp-		
oncologiste	oncologiste	Ncbms-		
oncologistes	oncologiste	Ncbmp-		
oncologue	oncologue	Ncbms-		
oncologues	oncologue	Ncbmp-		
onologue	onologue	Ncbms-		
onologues	onologue	Ncbmp-		
opérateur	opérateur	Ncbms-		
opérateurs	opérateur	Ncbmp-		
ophtalmologue	ophtalmologue	Ncbms-		
ophtalmologues	ophtalmologue	Ncbmp-		
opticien	opticien	Ncbms-		
opticiens	opticien	Ncbmp-		
optométriste	optométriste	Ncbms-		
optométristes	optométriste	Ncbmp-		
orateur	orateur	Ncbms-		
orateurs	orateur	Ncbmp-		
orchestrateur	orchestrateur	Ncbms-		
orchestrateurs	orchestrateur	Ncbmp-		
ordonnateur	ordonnateur	Ncbms-		
ordonnateurs	ordonnateur	Ncbmp-		
orfèvre	orfèvre	Ncbms-		
orfèvres	orfèvre	Ncbmp-		
organier	organier	Ncbms-		
organiers	organier	Ncbmp-		
organisateur	organisateur	Ncbms-		
organisateurs	organisateur	Ncbmp-		
organiste	organiste	Ncbms-		
organistes	organiste	Ncbmp-		
orienteur	orienteur	Ncbms-		
orienteurs	orienteur	Ncbmp-		
ornemaniste	ornemaniste	Ncbms-		
ornemanistes	ornemaniste	Ncbmp-		
ornithologue	ornithologue	Ncbms-		
ornithologues	ornithologue	Ncbmp-		
orpailleur	orpailleur	Ncbms-		
orpailleurs	orpailleur	Ncbmp-		
orthésiste	orthésiste	Ncbms-		
orthésistes	orthésiste	Ncbmp-		
orthodontiste	orthodontiste	Ncbms-		
orthodontistes	orthodontiste	Ncbmp-		
orthopédiste	orthopédiste	Ncbms-		
orthopédistes	orthopédiste	Ncbmp-		
orthophoniste	orthophoniste	Ncbms-		
orthophonistes	orthophoniste	Ncbmp-		
orthoprothésiste	orthoprothésiste	Ncbms-		
orthoprothésistes	orthoprothésiste	Ncbmp-		
orthoptiste	orthoptiste	Ncbms-		
orthoptistes	orthoptiste	Ncbmp-		
O.S.	O.S.	Ncbms-		
O.S.s	O.S.	Ncbmp-		
osiériculteur	osiériculteur	Ncbms-		
osiériculteurs	osiériculteur	Ncbmp-		
ostéologue	ostéologue	Ncbms-		
ostéologues	ostéologue	Ncbmp-		
ostéopathe	ostéopathe	Ncbms-		
ostéopathes	ostéopathe	Ncbmp-		
ostréiculteur	ostréiculteur	Ncbms-		
ostréiculteurs	ostréiculteur	Ncbmp-		
otorhinolaryngologiste	otorhinolaryngologiste	Ncbms-		
otorhinolaryngologistes	otorhinolaryngologiste	Ncbmp-		
ourdisseur	ourdisseur	Ncbms-		
ourdisseurs	ourdisseur	Ncbmp-		
ourleur	ourleur	Ncbms-		
ourleurs	ourleur	Ncbmp-		
outilleur	outilleur	Ncbms-		
outilleurs	outilleur	Ncbmp-		
ouvreur	ouvreur	Ncbms-		
ouvreurs	ouvreur	Ncbmp-		
ouvrier	ouvrier	Ncbms-		
ouvriers	ouvrier	Ncbmp-		
oxycoupeur	oxycoupeur	Ncbms-		
oxycoupeurs	oxycoupeur	Ncbmp-		
palefrenier	palefrenier	Ncbms-		
palefreniers	palefrenier	Ncbmp-		
paléographe	paléographe	Ncbms-		
paléographes	paléographe	Ncbmp-		
paléomagnéticien	paléomagnéticien	Ncbms-		
paléomagnéticiens	paléomagnéticien	Ncbmp-		
paléontologue	paléontologue	Ncbms-		
paléontologues	paléontologue	Ncbmp-		
paléovertébriste	paléovertébriste	Ncbms-		
paléovertébristes	paléovertébriste	Ncbmp-		
paletteur	paletteur	Ncbms-		
paletteurs	paletteur	Ncbmp-		
palettiseur	palettiseur	Ncbms-		
palettiseurs	palettiseur	Ncbmp-		
palissonneur	palissonneur	Ncbms-		
palissonneurs	palissonneur	Ncbmp-		
paludier	paludier	Ncbms-		
paludiers	paludier	Ncbmp-		
palynologue	palynologue	Ncbms-		
palynologues	palynologue	Ncbmp-		
panseur	panseur	Ncbms-		
panseurs	panseur	Ncbmp-		
pantograveur	pantograveur	Ncbms-		
pantograveurs	pantograveur	Ncbmp-		
pantomime	pantomime	Ncbms-		
pantomimes	pantomime	Ncbmp-		
papetier	papetier	Ncbms-		
papetiers	papetier	Ncbmp-		
papillonneur	papillonneur	Ncbms-		
papillonneurs	papillonneur	Ncbmp-		
parachutiste	parachutiste	Ncbms-		
parachutistes	parachutiste	Ncbmp-		
parapentiste	parapentiste	Ncbms-		
parapentistes	parapentiste	Ncbmp-		
parasitologue	parasitologue	Ncbms-		
parasitologues	parasitologue	Ncbmp-		
pareur	pareur	Ncbms-		
pareurs	pareur	Ncbmp-		
parfumeur	parfumeur	Ncbms-		
parfumeurs	parfumeur	Ncbmp-		
parieur	parieur	Ncbms-		
parieurs	parieur	Ncbmp-		
parlementaire	parlementaire	Ncbms-		
parlementaires	parlementaire	Ncbmp-		
parolier	parolier	Ncbms-		
paroliers	parolier	Ncbmp-		
parqueteur	parqueteur	Ncbms-		
parqueteurs	parqueteur	Ncbmp-		
parquetier	parquetier	Ncbms-		
parquetiers	parquetier	Ncbmp-		
parraineur	parraineur	Ncbms-		
parraineurs	parraineur	Ncbmp-		
parurier	parurier	Ncbms-		
paruriers	parurier	Ncbmp-		
passementier	passementier	Ncbms-		
passementiers	passementier	Ncbmp-		
passeur	passeur	Ncbms-		
passeurs	passeur	Ncbmp-		
pastelliste	pastelliste	Ncbms-		
pastellistes	pastelliste	Ncbmp-		
pasteur	pasteur	Ncbms-		
pasteurs	pasteur	Ncbmp-		
pasteurisateur	pasteurisateur	Ncbms-		
pasteurisateurs	pasteurisateur	Ncbmp-		
pathologiste	pathologiste	Ncbms-		
pathologistes	pathologiste	Ncbmp-		
patient	patient	Ncbms-		
patients	patient	Ncbmp-		
patineur	patineur	Ncbms-		
patineurs	patineur	Ncbmp-		
pâtissier	pâtissier	Ncbms-		
pâtissiers	pâtissier	Ncbmp-		
patron	patron	Ncbms-		
patrons	patron	Ncbmp-		
patronnier	patronnier	Ncbms-		
patronniers	patronnier	Ncbmp-		
patronniste	patronniste	Ncbms-		
patronnistes	patronniste	Ncbmp-		
patrouilleur	patrouilleur	Ncbms-		
patrouilleurs	patrouilleur	Ncbmp-		
paveur	paveur	Ncbms-		
paveurs	paveur	Ncbmp-		
payeur	payeur	Ncbms-		
payeurs	payeur	Ncbmp-		
paysagiste	paysagiste	Ncbms-		
paysagistes	paysagiste	Ncbmp-		
P.D.G.	P.D.G.	Ncbms-		
P.D.G.s	P.D.G.	Ncbmp-		
péager	péager	Ncbms-		
péagers	péager	Ncbmp-		
péagiste	péagiste	Ncbms-		
péagistes	péagiste	Ncbmp-		
peaussier	peaussier	Ncbms-		
peaussiers	peaussier	Ncbmp-		
pêcheur	pêcheur	Ncbms-		
pêcheurs	pêcheur	Ncbmp-		
pectiniculteur	pectiniculteur	Ncbms-		
pectiniculteurs	pectiniculteur	Ncbmp-		
pédagogue	pédagogue	Ncbms-		
pédagogues	pédagogue	Ncbmp-		
pédiatre	pédiatre	Ncbms-		
pédiatres	pédiatre	Ncbmp-		
pédicure	pédicure	Ncbms-		
pédicures	pédicure	Ncbmp-		
pédodontiste	pédodontiste	Ncbms-		
pédodontistes	pédodontiste	Ncbmp-		
pédologue	pédologue	Ncbms-		
pédologues	pédologue	Ncbmp-		
pédopsychiatre	pédopsychiatre	Ncbms-		
pédopsychiatres	pédopsychiatre	Ncbmp-		
peigneur	peigneur	Ncbms-		
peigneurs	peigneur	Ncbmp-		
peintre	peintre	Ncbms-		
peintres	peintre	Ncbmp-		
pèlerin	pèlerin	Ncbms-		
pèlerins	pèlerin	Ncbmp-		
peleur	peleur	Ncbms-		
peleurs	peleur	Ncbmp-		
pelleur	pelleur	Ncbms-		
pelleurs	pelleur	Ncbmp-		
pelotonneur	pelotonneur	Ncbms-		
pelotonneurs	pelotonneur	Ncbmp-		
pendulier	pendulier	Ncbms-		
penduliers	pendulier	Ncbmp-		
pénicheur	pénicheur	Ncbms-		
pénicheurs	pénicheur	Ncbmp-		
pénichier	pénichier	Ncbms-		
pénichiers	pénichier	Ncbmp-		
pénologue	pénologue	Ncbms-		
pénologues	pénologue	Ncbmp-		
pépiniériste	pépiniériste	Ncbms-		
pépiniéristes	pépiniériste	Ncbmp-		
percepteur	percepteur	Ncbms-		
percepteurs	percepteur	Ncbmp-		
perceur	perceur	Ncbms-		
perceurs	perceur	Ncbmp-		
perchiste	perchiste	Ncbms-		
perchistes	perchiste	Ncbmp-		
percussionniste	percussionniste	Ncbms-		
percussionnistes	percussionniste	Ncbmp-		
père abbé	père abbé	Ncbms-		
père abbés	père abbé	Ncbmp-		
perforateur	perforateur	Ncbms-		
perforateurs	perforateur	Ncbmp-		
perforeur	perforeur	Ncbms-		
perforeurs	perforeur	Ncbmp-		
performeur	performeur	Ncbms-		
performeurs	performeur	Ncbmp-		
permanent	permanent	Ncbms-		
permanents	permanent	Ncbmp-		
permanentiste	permanentiste	Ncbms-		
permanentistes	permanentiste	Ncbmp-		
perruquier	perruquier	Ncbms-		
perruquiers	perruquier	Ncbmp-		
peseur	peseur	Ncbms-		
peseurs	peseur	Ncbmp-		
pétissier	pétissier	Ncbms-		
pétissiers	pétissier	Ncbmp-		
pétrisseur	pétrisseur	Ncbms-		
pétrisseurs	pétrisseur	Ncbmp-		
pétrographe	pétrographe	Ncbms-		
pétrographes	pétrographe	Ncbmp-		
pharmacien	pharmacien	Ncbms-		
pharmaciens	pharmacien	Ncbmp-		
pharmacocinéticien	pharmacocinéticien	Ncbms-		
pharmacocinéticiens	pharmacocinéticien	Ncbmp-		
pharmacologue	pharmacologue	Ncbms-		
pharmacologues	pharmacologue	Ncbmp-		
philologue	philologue	Ncbms-		
philologues	philologue	Ncbmp-		
philosophe	philosophe	Ncbms-		
philosophes	philosophe	Ncbmp-		
phlébologue	phlébologue	Ncbms-		
phlébologues	phlébologue	Ncbmp-		
phonéticien	phonéticien	Ncbms-		
phonéticiens	phonéticien	Ncbmp-		
phoniatre	phoniatre	Ncbms-		
phoniatres	phoniatre	Ncbmp-		
phonothécaire	phonothécaire	Ncbms-		
phonothécaires	phonothécaire	Ncbmp-		
phosphateur	phosphateur	Ncbms-		
phosphateurs	phosphateur	Ncbmp-		
photochimiste	photochimiste	Ncbms-		
photochimistes	photochimiste	Ncbmp-		
photocompositeur	photocompositeur	Ncbms-		
photocompositeurs	photocompositeur	Ncbmp-		
photocopiste	photocopiste	Ncbms-		
photocopistes	photocopiste	Ncbmp-		
photogrammètre	photogrammètre	Ncbms-		
photogrammètres	photogrammètre	Ncbmp-		
photographe	photographe	Ncbms-		
photographes	photographe	Ncbmp-		
photograveur	photograveur	Ncbms-		
photograveurs	photograveur	Ncbmp-		
photoreproducteur	photoreproducteur	Ncbms-		
photoreproducteurs	photoreproducteur	Ncbmp-		
physicien	physicien	Ncbms-		
physiciens	physicien	Ncbmp-		
physiologiste	physiologiste	Ncbms-		
physiologistes	physiologiste	Ncbmp-		
physionomiste	physionomiste	Ncbms-		
physionomistes	physionomiste	Ncbmp-		
pianiste	pianiste	Ncbms-		
pianistes	pianiste	Ncbmp-		
picador	picador	Ncbms-		
picadors	picador	Ncbmp-		
piéceur	piéceur	Ncbms-		
piéceurs	piéceur	Ncbmp-		
pierriste	pierriste	Ncbms-		
pierristes	pierriste	Ncbmp-		
pigiste	pigiste	Ncbms-		
pigistes	pigiste	Ncbmp-		
pilonnier	pilonnier	Ncbms-		
pilonniers	pilonnier	Ncbmp-		
pilote	pilote	Ncbms-		
pilotes	pilote	Ncbmp-		
pipelinier	pipelinier	Ncbms-		
pipeliniers	pipelinier	Ncbmp-		
pipier	pipier	Ncbms-		
pipiers	pipier	Ncbmp-		
piqueur	piqueur	Ncbms-		
piqueurs	piqueur	Ncbmp-		
piqurier	piqurier	Ncbms-		
piquriers	piqurier	Ncbmp-		
pisciculteur	pisciculteur	Ncbms-		
pisciculteurs	pisciculteur	Ncbmp-		
piscinier	piscinier	Ncbms-		
pisciniers	piscinier	Ncbmp-		
pistard	pistard	Ncbms-		
pistards	pistard	Ncbmp-		
pisteur	pisteur	Ncbms-		
pisteurs	pisteur	Ncbmp-		
pistoleteur	pistoleteur	Ncbms-		
pistoleteurs	pistoleteur	Ncbmp-		
pistoleur	pistoleur	Ncbms-		
pistoleurs	pistoleur	Ncbmp-		
pizzaïolo	pizzaïolo	Ncbms-		
pizzaïolos	pizzaïolo	Ncbmp-		
pizzaïolo	pizzaïolo	Ncbms-		
pizzaïolos	pizzaïolo	Ncbmp-		
placagiste	placagiste	Ncbms-		
placagistes	placagiste	Ncbmp-		
placeur	placeur	Ncbms-		
placeurs	placeur	Ncbmp-		
placier	placier	Ncbms-		
placiers	placier	Ncbmp-		
plafonneur	plafonneur	Ncbms-		
plafonneurs	plafonneur	Ncbmp-		
plagiste	plagiste	Ncbms-		
plagistes	plagiste	Ncbmp-		
plaignant	plaignant	Ncbms-		
plaignants	plaignant	Ncbmp-		
plancheur	plancheur	Ncbms-		
plancheurs	plancheur	Ncbmp-		
planchiste	planchiste	Ncbms-		
planchistes	planchiste	Ncbmp-		
planétologue	planétologue	Ncbms-		
planétologues	planétologue	Ncbmp-		
planeur	planeur	Ncbms-		
planeurs	planeur	Ncbmp-		
planificateur	planificateur	Ncbms-		
planificateurs	planificateur	Ncbmp-		
planteur	planteur	Ncbms-		
planteurs	planteur	Ncbmp-		
planton	planton	Ncbms-		
plantons	planton	Ncbmp-		
plaqueur	plaqueur	Ncbms-		
plaqueurs	plaqueur	Ncbmp-		
plaquiste	plaquiste	Ncbms-		
plaquistes	plaquiste	Ncbmp-		
plasticien	plasticien	Ncbms-		
plasticiens	plasticien	Ncbmp-		
plastifieur	plastifieur	Ncbms-		
plastifieurs	plastifieur	Ncbmp-		
plasturgiste	plasturgiste	Ncbms-		
plasturgistes	plasturgiste	Ncbmp-		
plate-formiste	plate-formiste	Ncbms-		
plate-formistes	plate-formiste	Ncbmp-		
plâtrier	plâtrier	Ncbms-		
plâtriers	plâtrier	Ncbmp-		
plieur	plieur	Ncbms-		
plieurs	plieur	Ncbmp-		
plombeur	plombeur	Ncbms-		
plombeurs	plombeur	Ncbmp-		
plombier	plombier	Ncbms-		
plombiers	plombier	Ncbmp-		
plongeur	plongeur	Ncbms-		
plongeurs	plongeur	Ncbmp-		
plumassier	plumassier	Ncbms-		
plumassiers	plumassier	Ncbmp-		
plumiste	plumiste	Ncbms-		
plumistes	plumiste	Ncbmp-		
pneumaticien	pneumaticien	Ncbms-		
pneumaticiens	pneumaticien	Ncbmp-		
pneumatiquier	pneumatiquier	Ncbms-		
pneumatiquiers	pneumatiquier	Ncbmp-		
pneumologue	pneumologue	Ncbms-		
pneumologues	pneumologue	Ncbmp-		
pocheteur	pocheteur	Ncbms-		
pocheteurs	pocheteur	Ncbmp-		
pocheur	pocheur	Ncbms-		
pocheurs	pocheur	Ncbmp-		
podologue	podologue	Ncbms-		
podologues	podologue	Ncbmp-		
poêlier	poêlier	Ncbms-		
poêliers	poêlier	Ncbmp-		
poète	poète	Ncbms-		
poètes	poète	Ncbmp-		
poinçonneur	poinçonneur	Ncbms-		
poinçonneurs	poinçonneur	Ncbmp-		
pointeur	pointeur	Ncbms-		
pointeurs	pointeur	Ncbmp-		
poissonnier	poissonnier	Ncbms-		
poissonniers	poissonnier	Ncbmp-		
policier	policier	Ncbms-		
policiers	policier	Ncbmp-		
polisseur	polisseur	Ncbms-		
polisseurs	polisseur	Ncbmp-		
politicien	politicien	Ncbms-		
politiciens	politicien	Ncbmp-		
politologue	politologue	Ncbms-		
politologues	politologue	Ncbmp-		
polycopiste	polycopiste	Ncbms-		
polycopistes	polycopiste	Ncbmp-		
polymériste	polymériste	Ncbms-		
polyméristes	polymériste	Ncbmp-		
polytechnicien	polytechnicien	Ncbms-		
polytechniciens	polytechnicien	Ncbmp-		
pomiculteur	pomiculteur	Ncbms-		
pomiculteurs	pomiculteur	Ncbmp-		
pomologue	pomologue	Ncbms-		
pomologues	pomologue	Ncbmp-		
pompier	pompier	Ncbms-		
pompiers	pompier	Ncbmp-		
pompiste	pompiste	Ncbms-		
pompistes	pompiste	Ncbmp-		
ponceur	ponceur	Ncbms-		
ponceurs	ponceur	Ncbmp-		
pongiste	pongiste	Ncbms-		
pongistes	pongiste	Ncbmp-		
pontier	pontier	Ncbms-		
pontiers	pontier	Ncbmp-		
pontonnier	pontonnier	Ncbms-		
pontonniers	pontonnier	Ncbmp-		
populiculteur	populiculteur	Ncbms-		
populiculteurs	populiculteur	Ncbmp-		
porcelainier	porcelainier	Ncbms-		
porcelainiers	porcelainier	Ncbmp-		
porcher	porcher	Ncbms-		
porchers	porcher	Ncbmp-		
porion	porion	Ncbms-		
porions	porion	Ncbmp-		
portefeuilliste	portefeuilliste	Ncbms-		
portefeuillistes	portefeuilliste	Ncbmp-		
porte-parole	porte-parole	Ncbms-		
porte-paroles	porte-parole	Ncbmp-		
porteur	porteur	Ncbms-		
porteurs	porteur	Ncbmp-		
portier	portier	Ncbms-		
portiers	portier	Ncbmp-		
portiqueur	portiqueur	Ncbms-		
portiqueurs	portiqueur	Ncbmp-		
portraitiste	portraitiste	Ncbms-		
portraitistes	portraitiste	Ncbmp-		
poseur	poseur	Ncbms-		
poseurs	poseur	Ncbmp-		
postier	postier	Ncbms-		
postiers	postier	Ncbmp-		
postulant	postulant	Ncbms-		
postulants	postulant	Ncbmp-		
potier	potier	Ncbms-		
potiers	potier	Ncbmp-		
poudrier	poudrier	Ncbms-		
poudriers	poudrier	Ncbmp-		
pourvoyeur	pourvoyeur	Ncbms-		
pourvoyeurs	pourvoyeur	Ncbmp-		
pousseur	pousseur	Ncbms-		
pousseurs	pousseur	Ncbmp-		
poussin	poussin	Ncbms-		
poussins	poussin	Ncbmp-		
praticien	praticien	Ncbms-		
praticiens	praticien	Ncbmp-		
pratiquant	pratiquant	Ncbms-		
pratiquants	pratiquant	Ncbmp-		
précepteur	précepteur	Ncbms-		
précepteurs	précepteur	Ncbmp-		
prédicateur	prédicateur	Ncbms-		
prédicateurs	prédicateur	Ncbmp-		
préfet	préfet	Ncbms-		
préfets	préfet	Ncbmp-		
préleveur	préleveur	Ncbms-		
préleveurs	préleveur	Ncbmp-		
premier	premier	Ncbms-		
premiers	premier	Ncbmp-		
preneur	preneur	Ncbms-		
preneurs	preneur	Ncbmp-		
préparateur	préparateur	Ncbms-		
préparateurs	préparateur	Ncbmp-		
préposé	préposé	Ncbms-		
préposés	préposé	Ncbmp-		
présentateur	présentateur	Ncbms-		
présentateurs	présentateur	Ncbmp-		
président	président	Ncbms-		
présidents	président	Ncbmp-		
presseur	presseur	Ncbms-		
presseurs	presseur	Ncbmp-		
pressier	pressier	Ncbms-		
pressiers	pressier	Ncbmp-		
prestidigitateur	prestidigitateur	Ncbms-		
prestidigitateurs	prestidigitateur	Ncbmp-		
préventionniste	préventionniste	Ncbms-		
préventionnistes	préventionniste	Ncbmp-		
préventologue	préventologue	Ncbms-		
préventologues	préventologue	Ncbmp-		
prévisionniste	prévisionniste	Ncbms-		
prévisionnistes	prévisionniste	Ncbmp-		
prieur	prieur	Ncbms-		
prieurs	prieur	Ncbmp-		
primatologue	primatologue	Ncbms-		
primatologues	primatologue	Ncbmp-		
primeuriste	primeuriste	Ncbms-		
primeuristes	primeuriste	Ncbmp-		
prince	prince	Ncbms-		
princes	prince	Ncbmp-		
principal	principal	Ncbms-		
principals	principal	Ncbmp-		
priseur	priseur	Ncbms-		
priseurs	priseur	Ncbmp-		
privé	privé	Ncbms-		
privés	privé	Ncbmp-		
procureur	procureur	Ncbms-		
procureurs	procureur	Ncbmp-		
producteur	producteur	Ncbms-		
producteurs	producteur	Ncbmp-		
professeur	professeur	Ncbms-		
professeurs	professeur	Ncbmp-		
professionnel	professionnel	Ncbms-		
professionnels	professionnel	Ncbmp-		
profileur	profileur	Ncbms-		
profileurs	profileur	Ncbmp-		
programmateur	programmateur	Ncbms-		
programmateurs	programmateur	Ncbmp-		
programmeur	programmeur	Ncbms-		
programmeurs	programmeur	Ncbmp-		
projectionniste	projectionniste	Ncbms-		
projectionnistes	projectionniste	Ncbmp-		
projeteur	projeteur	Ncbms-		
projeteurs	projeteur	Ncbmp-		
promoteur	promoteur	Ncbms-		
promoteurs	promoteur	Ncbmp-		
proposeur	proposeur	Ncbms-		
proposeurs	proposeur	Ncbmp-		
prospecteur	prospecteur	Ncbms-		
prospecteurs	prospecteur	Ncbmp-		
prospectiviste	prospectiviste	Ncbms-		
prospectivistes	prospectiviste	Ncbmp-		
prostitué	prostitué	Ncbms-		
prostitués	prostitué	Ncbmp-		
prote	prote	Ncbms-		
protes	prote	Ncbmp-		
prothésiste	prothésiste	Ncbms-		
prothésistes	prothésiste	Ncbmp-		
prototypiste	prototypiste	Ncbms-		
prototypistes	prototypiste	Ncbmp-		
proviseur	proviseur	Ncbms-		
proviseurs	proviseur	Ncbmp-		
prudhomme	prudhomme	Ncbms-		
prudhommes	prudhomme	Ncbmp-		
prud'homme	prud'homme	Ncbms-		
prud'hommes	prud'homme	Ncbmp-		
pruniculteur	pruniculteur	Ncbms-		
pruniculteurs	pruniculteur	Ncbmp-		
psychanalyste	psychanalyste	Ncbms-		
psychanalystes	psychanalyste	Ncbmp-		
psychiatre	psychiatre	Ncbms-		
psychiatres	psychiatre	Ncbmp-		
psychoclinicien	psychoclinicien	Ncbms-		
psychocliniciens	psychoclinicien	Ncbmp-		
psychologue	psychologue	Ncbms-		
psychologues	psychologue	Ncbmp-		
psychométricien	psychométricien	Ncbms-		
psychométriciens	psychométricien	Ncbmp-		
psychomotricien	psychomotricien	Ncbms-		
psychomotriciens	psychomotricien	Ncbmp-		
psychopathologue	psychopathologue	Ncbms-		
psychopathologues	psychopathologue	Ncbmp-		
publiciste	publiciste	Ncbms-		
publicistes	publiciste	Ncbmp-		
publicitaire	publicitaire	Ncbms-		
publicitaires	publicitaire	Ncbmp-		
puériculteur	puériculteur	Ncbms-		
puériculteurs	puériculteur	Ncbmp-		
puisatier	puisatier	Ncbms-		
puisatiers	puisatier	Ncbmp-		
puiseur	puiseur	Ncbms-		
puiseurs	puiseur	Ncbmp-		
pulpeur	pulpeur	Ncbms-		
pulpeurs	pulpeur	Ncbmp-		
pupitreur	pupitreur	Ncbms-		
pupitreurs	pupitreur	Ncbmp-		
purgeur	purgeur	Ncbms-		
purgeurs	purgeur	Ncbmp-		
pyrotechnicien	pyrotechnicien	Ncbms-		
pyrotechniciens	pyrotechnicien	Ncbmp-		
quadrille	quadrille	Ncbms-		
quadrilles	quadrille	Ncbmp-		
qualiticien	qualiticien	Ncbms-		
qualiticiens	qualiticien	Ncbmp-		
quartier-maitre	quartier-maitre	Ncbms-		
quartier-maitres	quartier-maitre	Ncbmp-		
quenouilleur	quenouilleur	Ncbms-		
quenouilleurs	quenouilleur	Ncbmp-		
questeur	questeur	Ncbms-		
questeurs	questeur	Ncbmp-		
questionneur	questionneur	Ncbms-		
questionneurs	questionneur	Ncbmp-		
quincailler	quincailler	Ncbms-		
quincaillers	quincailler	Ncbmp-		
rabatteur	rabatteur	Ncbms-		
rabatteurs	rabatteur	Ncbmp-		
rabbin	rabbin	Ncbms-		
rabbins	rabbin	Ncbmp-		
raboteur	raboteur	Ncbms-		
raboteurs	raboteur	Ncbmp-		
raccommodeur	raccommodeur	Ncbms-		
raccommodeurs	raccommodeur	Ncbmp-		
raccoutreur	raccoutreur	Ncbms-		
raccoutreurs	raccoutreur	Ncbmp-		
radariste	radariste	Ncbms-		
radaristes	radariste	Ncbmp-		
radiesthésiste	radiesthésiste	Ncbms-		
radiesthésistes	radiesthésiste	Ncbmp-		
radiologiste	radiologiste	Ncbms-		
radiologistes	radiologiste	Ncbmp-		
radiologue	radiologue	Ncbms-		
radiologues	radiologue	Ncbmp-		
radioprotectionniste	radioprotectionniste	Ncbms-		
radioprotectionnistes	radioprotectionniste	Ncbmp-		
raffineur	raffineur	Ncbms-		
raffineurs	raffineur	Ncbmp-		
ragréeur	ragréeur	Ncbms-		
ragréeurs	ragréeur	Ncbmp-		
ramasseur	ramasseur	Ncbms-		
ramasseurs	ramasseur	Ncbmp-		
ramendeur	ramendeur	Ncbms-		
ramendeurs	ramendeur	Ncbmp-		
rameur	rameur	Ncbms-		
rameurs	rameur	Ncbmp-		
ramoneur	ramoneur	Ncbms-		
ramoneurs	ramoneur	Ncbmp-		
rampiste	rampiste	Ncbms-		
rampistes	rampiste	Ncbmp-		
randonneur	randonneur	Ncbms-		
randonneurs	randonneur	Ncbmp-		
rapetasseur	rapetasseur	Ncbms-		
rapetasseurs	rapetasseur	Ncbmp-		
râpeur	râpeur	Ncbms-		
râpeurs	râpeur	Ncbmp-		
rapporteur	rapporteur	Ncbms-		
rapporteurs	rapporteur	Ncbmp-		
rattacheur	rattacheur	Ncbms-		
rattacheurs	rattacheur	Ncbmp-		
ravaleur	ravaleur	Ncbms-		
ravaleurs	ravaleur	Ncbmp-		
ravaudeur	ravaudeur	Ncbms-		
ravaudeurs	ravaudeur	Ncbmp-		
ravitailleur	ravitailleur	Ncbms-		
ravitailleurs	ravitailleur	Ncbmp-		
raviveur	raviveur	Ncbms-		
raviveurs	raviveur	Ncbmp-		
rayonneur	rayonneur	Ncbms-		
rayonneurs	rayonneur	Ncbmp-		
réalisateur	réalisateur	Ncbms-		
réalisateurs	réalisateur	Ncbmp-		
réanimateur	réanimateur	Ncbms-		
réanimateurs	réanimateur	Ncbmp-		
réapprovisionneur	réapprovisionneur	Ncbms-		
réapprovisionneurs	réapprovisionneur	Ncbmp-		
réassortisseur	réassortisseur	Ncbms-		
réassortisseurs	réassortisseur	Ncbmp-		
rebobineur	rebobineur	Ncbms-		
rebobineurs	rebobineur	Ncbmp-		
reboiseur	reboiseur	Ncbms-		
reboiseurs	reboiseur	Ncbmp-		
rebouteur	rebouteur	Ncbms-		
rebouteurs	rebouteur	Ncbmp-		
rebrousseur	rebrousseur	Ncbms-		
rebrousseurs	rebrousseur	Ncbmp-		
recenseur	recenseur	Ncbms-		
recenseurs	recenseur	Ncbmp-		
récepteur	récepteur	Ncbms-		
récepteurs	récepteur	Ncbmp-		
réceptionnaire	réceptionnaire	Ncbms-		
réceptionnaires	réceptionnaire	Ncbmp-		
réceptionniste	réceptionniste	Ncbms-		
réceptionnistes	réceptionniste	Ncbmp-		
receveur	receveur	Ncbms-		
receveurs	receveur	Ncbmp-		
réchappeur	réchappeur	Ncbms-		
réchappeurs	réchappeur	Ncbmp-		
réchauffeur	réchauffeur	Ncbms-		
réchauffeurs	réchauffeur	Ncbmp-		
recherchiste	recherchiste	Ncbms-		
recherchistes	recherchiste	Ncbmp-		
recouvreur	recouvreur	Ncbms-		
recouvreurs	recouvreur	Ncbmp-		
recruteur	recruteur	Ncbms-		
recruteurs	recruteur	Ncbmp-		
recteur	recteur	Ncbms-		
recteurs	recteur	Ncbmp-		
rectifieur	rectifieur	Ncbms-		
rectifieurs	rectifieur	Ncbmp-		
recuiseur	recuiseur	Ncbms-		
recuiseurs	recuiseur	Ncbmp-		
récupérateur	récupérateur	Ncbms-		
récupérateurs	récupérateur	Ncbmp-		
rédacteur	rédacteur	Ncbms-		
rédacteurs	rédacteur	Ncbmp-		
rédemptoriste	rédemptoriste	Ncbms-		
rédemptoristes	rédemptoriste	Ncbmp-		
redresseur	redresseur	Ncbms-		
redresseurs	redresseur	Ncbmp-		
rééducateur	rééducateur	Ncbms-		
rééducateurs	rééducateur	Ncbmp-		
refendeur	refendeur	Ncbms-		
refendeurs	refendeur	Ncbmp-		
réflexologiste	réflexologiste	Ncbms-		
réflexologistes	réflexologiste	Ncbmp-		
réflexologue	réflexologue	Ncbms-		
réflexologues	réflexologue	Ncbmp-		
régaleur	régaleur	Ncbms-		
régaleurs	régaleur	Ncbmp-		
régent	régent	Ncbms-		
régents	régent	Ncbmp-		
régisseur	régisseur	Ncbms-		
régisseurs	régisseur	Ncbmp-		
régleur	régleur	Ncbms-		
régleurs	régleur	Ncbmp-		
régulateur	régulateur	Ncbms-		
régulateurs	régulateur	Ncbmp-		
relationniste	relationniste	Ncbms-		
relationnistes	relationniste	Ncbmp-		
relaxologue	relaxologue	Ncbms-		
relaxologues	relaxologue	Ncbmp-		
releveur	releveur	Ncbms-		
releveurs	releveur	Ncbmp-		
relieur	relieur	Ncbms-		
relieurs	relieur	Ncbmp-		
religieux	religieux	Ncbms-		
religieuxs	religieux	Ncbmp-		
remailleur	remailleur	Ncbms-		
remailleurs	remailleur	Ncbmp-		
rembobineur	rembobineur	Ncbms-		
rembobineurs	rembobineur	Ncbmp-		
rembordeur	rembordeur	Ncbms-		
rembordeurs	rembordeur	Ncbmp-		
rembourreur	rembourreur	Ncbms-		
rembourreurs	rembourreur	Ncbmp-		
remmailleur	remmailleur	Ncbms-		
remmailleurs	remmailleur	Ncbmp-		
remmouleur	remmouleur	Ncbms-		
remmouleurs	remmouleur	Ncbmp-		
remolieur	remolieur	Ncbms-		
remolieurs	remolieur	Ncbmp-		
remonteur	remonteur	Ncbms-		
remonteurs	remonteur	Ncbmp-		
remorqueur	remorqueur	Ncbms-		
remorqueurs	remorqueur	Ncbmp-		
rémouleur	rémouleur	Ncbms-		
rémouleurs	rémouleur	Ncbmp-		
rempailleur	rempailleur	Ncbms-		
rempailleurs	rempailleur	Ncbmp-		
remplaçant	remplaçant	Ncbms-		
remplaçants	remplaçant	Ncbmp-		
remplieur	remplieur	Ncbms-		
remplieurs	remplieur	Ncbmp-		
rentrayeur	rentrayeur	Ncbms-		
rentrayeurs	rentrayeur	Ncbmp-		
rentreur	rentreur	Ncbms-		
rentreurs	rentreur	Ncbmp-		
renvideur	renvideur	Ncbms-		
renvideurs	renvideur	Ncbmp-		
réparateur	réparateur	Ncbms-		
réparateurs	réparateur	Ncbmp-		
répartiteur	répartiteur	Ncbms-		
répartiteurs	répartiteur	Ncbmp-		
repasseur	repasseur	Ncbms-		
repasseurs	repasseur	Ncbmp-		
reperceur	reperceur	Ncbms-		
reperceurs	reperceur	Ncbmp-		
répétiteur	répétiteur	Ncbms-		
répétiteurs	répétiteur	Ncbmp-		
repiqueur	repiqueur	Ncbms-		
repiqueurs	repiqueur	Ncbmp-		
répondant	répondant	Ncbms-		
répondants	répondant	Ncbmp-		
reporteur  [impr.]	reporteur  [impr.]	Ncbms-		
reporteur  [impr.]s	reporteur  [impr.]	Ncbmp-		
reporteur* [presse]	reporteur* [presse]	Ncbms-		
reporteur* [presse]s	reporteur* [presse]	Ncbmp-		
repousseur	repousseur	Ncbms-		
repousseurs	repousseur	Ncbmp-		
représentant	représentant	Ncbms-		
représentants	représentant	Ncbmp-		
reproducteur	reproducteur	Ncbms-		
reproducteurs	reproducteur	Ncbmp-		
reprographe	reprographe	Ncbms-		
reprographes	reprographe	Ncbmp-		
reprographiste	reprographiste	Ncbms-		
reprographistes	reprographiste	Ncbmp-		
requérant	requérant	Ncbms-		
requérants	requérant	Ncbmp-		
réserviste	réserviste	Ncbms-		
réservistes	réserviste	Ncbmp-		
résinier	résinier	Ncbms-		
résiniers	résinier	Ncbmp-		
responsable	responsable	Ncbms-		
responsables	responsable	Ncbmp-		
ressemeleur	ressemeleur	Ncbms-		
ressemeleurs	ressemeleur	Ncbmp-		
ressortier	ressortier	Ncbms-		
ressortiers	ressortier	Ncbmp-		
restaurateur	restaurateur	Ncbms-		
restaurateurs	restaurateur	Ncbmp-		
restituteur	restituteur	Ncbms-		
restituteurs	restituteur	Ncbmp-		
retailleur	retailleur	Ncbms-		
retailleurs	retailleur	Ncbmp-		
retapeur	retapeur	Ncbms-		
retapeurs	retapeur	Ncbmp-		
retordeur	retordeur	Ncbms-		
retordeurs	retordeur	Ncbmp-		
retoucheur	retoucheur	Ncbms-		
retoucheurs	retoucheur	Ncbmp-		
retraité	retraité	Ncbms-		
retraités	retraité	Ncbmp-		
réunisseur	réunisseur	Ncbms-		
réunisseurs	réunisseur	Ncbmp-		
revendeur	revendeur	Ncbms-		
revendeurs	revendeur	Ncbmp-		
révérend	révérend	Ncbms-		
révérends	révérend	Ncbmp-		
revêtisseur	revêtisseur	Ncbms-		
revêtisseurs	revêtisseur	Ncbmp-		
reviseur	reviseur	Ncbms-		
reviseurs	reviseur	Ncbmp-		
réviseur	réviseur	Ncbms-		
réviseurs	réviseur	Ncbmp-		
rhabilleur	rhabilleur	Ncbms-		
rhabilleurs	rhabilleur	Ncbmp-		
rhéteur	rhéteur	Ncbms-		
rhéteurs	rhéteur	Ncbmp-		
rhodieur	rhodieur	Ncbms-		
rhodieurs	rhodieur	Ncbmp-		
rhumatologue	rhumatologue	Ncbms-		
rhumatologues	rhumatologue	Ncbmp-		
rinceur	rinceur	Ncbms-		
rinceurs	rinceur	Ncbmp-		
ripeur	ripeur	Ncbms-		
ripeurs	ripeur	Ncbmp-		
riveur	riveur	Ncbms-		
riveurs	riveur	Ncbmp-		
riziculteur	riziculteur	Ncbms-		
riziculteurs	riziculteur	Ncbmp-		
robinetier	robinetier	Ncbms-		
robinetiers	robinetier	Ncbmp-		
roboticien	roboticien	Ncbms-		
roboticiens	roboticien	Ncbmp-		
rodeur	rodeur	Ncbms-		
rodeurs	rodeur	Ncbmp-		
rogneur	rogneur	Ncbms-		
rogneurs	rogneur	Ncbmp-		
roi	roi	Ncbms-		
rois	roi	Ncbmp-		
rollseur	rollseur	Ncbms-		
rollseurs	rollseur	Ncbmp-		
romancier	romancier	Ncbms-		
romanciers	romancier	Ncbmp-		
rondier	rondier	Ncbms-		
rondiers	rondier	Ncbmp-		
rondisseur	rondisseur	Ncbms-		
rondisseurs	rondisseur	Ncbmp-		
rosiériste	rosiériste	Ncbms-		
rosiéristes	rosiériste	Ncbmp-		
rotativiste	rotativiste	Ncbms-		
rotativistes	rotativiste	Ncbmp-		
rotinier	rotinier	Ncbms-		
rotiniers	rotinier	Ncbmp-		
rôtisseur	rôtisseur	Ncbms-		
rôtisseurs	rôtisseur	Ncbmp-		
rotomouleur	rotomouleur	Ncbms-		
rotomouleurs	rotomouleur	Ncbmp-		
roulant	roulant	Ncbms-		
roulants	roulant	Ncbmp-		
rouleur	rouleur	Ncbms-		
rouleurs	rouleur	Ncbmp-		
roulottier	roulottier	Ncbms-		
roulottiers	roulottier	Ncbmp-		
routeur	routeur	Ncbms-		
routeurs	routeur	Ncbmp-		
routier	routier	Ncbms-		
routiers	routier	Ncbmp-		
rubanier	rubanier	Ncbms-		
rubaniers	rubanier	Ncbmp-		
rudologue	rudologue	Ncbms-		
rudologues	rudologue	Ncbmp-		
rugbyman	rugbyman	Ncbms-		
rugbymans	rugbyman	Ncbmp-		
sableur	sableur	Ncbms-		
sableurs	sableur	Ncbmp-		
sabotier	sabotier	Ncbms-		
sabotiers	sabotier	Ncbmp-		
sabreur	sabreur	Ncbms-		
sabreurs	sabreur	Ncbmp-		
sacochier	sacochier	Ncbms-		
sacochiers	sacochier	Ncbmp-		
sacrificateur	sacrificateur	Ncbms-		
sacrificateurs	sacrificateur	Ncbmp-		
sacristain	sacristain	Ncbms-		
sacristains	sacristain	Ncbmp-		
safranier	safranier	Ncbms-		
safraniers	safranier	Ncbmp-		
saigneur	saigneur	Ncbms-		
saigneurs	saigneur	Ncbmp-		
saisonnier	saisonnier	Ncbms-		
saisonniers	saisonnier	Ncbmp-		
salaisonnier	salaisonnier	Ncbms-		
salaisonniers	salaisonnier	Ncbmp-		
salésien	salésien	Ncbms-		
salésiens	salésien	Ncbmp-		
saleur	saleur	Ncbms-		
saleurs	saleur	Ncbmp-		
saliculteur	saliculteur	Ncbms-		
saliculteurs	saliculteur	Ncbmp-		
salinier	salinier	Ncbms-		
saliniers	salinier	Ncbmp-		
salmoniculteur	salmoniculteur	Ncbms-		
salmoniculteurs	salmoniculteur	Ncbmp-		
salonnier	salonnier	Ncbms-		
salonniers	salonnier	Ncbmp-		
salpêtrier	salpêtrier	Ncbms-		
salpêtriers	salpêtrier	Ncbmp-		
saltimbanque	saltimbanque	Ncbms-		
saltimbanques	saltimbanque	Ncbmp-		
salutiste	salutiste	Ncbms-		
salutistes	salutiste	Ncbmp-		
sampanier	sampanier	Ncbms-		
sampaniers	sampanier	Ncbmp-		
sandalier	sandalier	Ncbms-		
sandaliers	sandalier	Ncbmp-		
santonnier	santonnier	Ncbms-		
santonniers	santonnier	Ncbmp-		
sapeur	sapeur	Ncbms-		
sapeurs	sapeur	Ncbmp-		
satineur	satineur	Ncbms-		
satineurs	satineur	Ncbmp-		
saucier	saucier	Ncbms-		
sauciers	saucier	Ncbmp-		
saunier	saunier	Ncbms-		
sauniers	saunier	Ncbmp-		
sauveteur	sauveteur	Ncbms-		
sauveteurs	sauveteur	Ncbmp-		
savant	savant	Ncbms-		
savants	savant	Ncbmp-		
saxophoniste	saxophoniste	Ncbms-		
saxophonistes	saxophoniste	Ncbmp-		
scannériste	scannériste	Ncbms-		
scannéristes	scannériste	Ncbmp-		
scanneuriste	scanneuriste	Ncbms-		
scanneuristes	scanneuriste	Ncbmp-		
scaphandrier	scaphandrier	Ncbms-		
scaphandriers	scaphandrier	Ncbmp-		
scénariste	scénariste	Ncbms-		
scénaristes	scénariste	Ncbmp-		
scénographe	scénographe	Ncbms-		
scénographes	scénographe	Ncbmp-		
schlitteur	schlitteur	Ncbms-		
schlitteurs	schlitteur	Ncbmp-		
scientifique	scientifique	Ncbms-		
scientifiques	scientifique	Ncbmp-		
scieur	scieur	Ncbms-		
scieurs	scieur	Ncbmp-		
scripte	scripte	Ncbms-		
scriptes	scripte	Ncbmp-		
scrutateur	scrutateur	Ncbms-		
scrutateurs	scrutateur	Ncbmp-		
sculpteur	sculpteur	Ncbms-		
sculpteurs	sculpteur	Ncbmp-		
sécheur	sécheur	Ncbms-		
sécheurs	sécheur	Ncbmp-		
second	second	Ncbms-		
seconds	second	Ncbmp-		
second*	second*	Ncbms-		
second*s	second*	Ncbmp-		
secoueur	secoueur	Ncbms-		
secoueurs	secoueur	Ncbmp-		
secouriste	secouriste	Ncbms-		
secouristes	secouriste	Ncbmp-		
secrétaire	secrétaire	Ncbms-		
secrétaires	secrétaire	Ncbmp-		
sédimentologiste	sédimentologiste	Ncbms-		
sédimentologistes	sédimentologiste	Ncbmp-		
séismologue	séismologue	Ncbms-		
séismologues	séismologue	Ncbmp-		
sélectionneur	sélectionneur	Ncbms-		
sélectionneurs	sélectionneur	Ncbmp-		
sellier	sellier	Ncbms-		
selliers	sellier	Ncbmp-		
semencier	semencier	Ncbms-		
semenciers	semencier	Ncbmp-		
semoulier	semoulier	Ncbms-		
semouliers	semoulier	Ncbmp-		
sénateur	sénateur	Ncbms-		
sénateurs	sénateur	Ncbmp-		
sénior	sénior	Ncbms-		
séniors	sénior	Ncbmp-		
sergent	sergent	Ncbms-		
sergents	sergent	Ncbmp-		
sériciculteur	sériciculteur	Ncbms-		
sériciculteurs	sériciculteur	Ncbmp-		
sérigraphe	sérigraphe	Ncbms-		
sérigraphes	sérigraphe	Ncbmp-		
sérologiste	sérologiste	Ncbms-		
sérologistes	sérologiste	Ncbmp-		
serriste	serriste	Ncbms-		
serristes	serriste	Ncbmp-		
serrurier	serrurier	Ncbms-		
serruriers	serrurier	Ncbmp-		
sertisseur	sertisseur	Ncbms-		
sertisseurs	sertisseur	Ncbmp-		
servant	servant	Ncbms-		
servants	servant	Ncbmp-		
serveur	serveur	Ncbms-		
serveurs	serveur	Ncbmp-		
sexologue	sexologue	Ncbms-		
sexologues	sexologue	Ncbmp-		
shampouineur	shampouineur	Ncbms-		
shampouineurs	shampouineur	Ncbmp-		
sidecariste	sidecariste	Ncbms-		
sidecaristes	sidecariste	Ncbmp-		
sidérurgiste	sidérurgiste	Ncbms-		
sidérurgistes	sidérurgiste	Ncbmp-		
signaleur	signaleur	Ncbms-		
signaleurs	signaleur	Ncbmp-		
signataire	signataire	Ncbms-		
signataires	signataire	Ncbmp-		
significateur	significateur	Ncbms-		
significateurs	significateur	Ncbmp-		
similiste	similiste	Ncbms-		
similistes	similiste	Ncbmp-		
siropier	siropier	Ncbms-		
siropiers	siropier	Ncbmp-		
sismicien	sismicien	Ncbms-		
sismiciens	sismicien	Ncbmp-		
sismologue	sismologue	Ncbms-		
sismologues	sismologue	Ncbmp-		
sitologue	sitologue	Ncbms-		
sitologues	sitologue	Ncbmp-		
skateur	skateur	Ncbms-		
skateurs	skateur	Ncbmp-		
skieur	skieur	Ncbms-		
skieurs	skieur	Ncbmp-		
skiffeur	skiffeur	Ncbms-		
skiffeurs	skiffeur	Ncbmp-		
skippeur	skippeur	Ncbms-		
skippeurs	skippeur	Ncbmp-		
sociologue	sociologue	Ncbms-		
sociologues	sociologue	Ncbmp-		
socleur	socleur	Ncbms-		
socleurs	socleur	Ncbmp-		
soignant	soignant	Ncbms-		
soignants	soignant	Ncbmp-		
soigneur	soigneur	Ncbms-		
soigneurs	soigneur	Ncbmp-		
soldat	soldat	Ncbms-		
soldats	soldat	Ncbmp-		
solier	solier	Ncbms-		
soliers	solier	Ncbmp-		
soliste	soliste	Ncbms-		
solistes	soliste	Ncbmp-		
sommelier	sommelier	Ncbms-		
sommeliers	sommelier	Ncbmp-		
sondeur	sondeur	Ncbms-		
sondeurs	sondeur	Ncbmp-		
sonneur	sonneur	Ncbms-		
sonneurs	sonneur	Ncbmp-		
sonorisateur	sonorisateur	Ncbms-		
sonorisateurs	sonorisateur	Ncbmp-		
sophrologue	sophrologue	Ncbms-		
sophrologues	sophrologue	Ncbmp-		
soprano	soprano	Ncbms-		
sopranos	soprano	Ncbmp-		
sorbonnier	sorbonnier	Ncbms-		
sorbonniers	sorbonnier	Ncbmp-		
sortant	sortant	Ncbms-		
sortants	sortant	Ncbmp-		
soudeur	soudeur	Ncbms-		
soudeurs	soudeur	Ncbmp-		
souffleur	souffleur	Ncbms-		
souffleurs	souffleur	Ncbmp-		
sourceur	sourceur	Ncbms-		
sourceurs	sourceur	Ncbmp-		
sourcier	sourcier	Ncbms-		
sourciers	sourcier	Ncbmp-		
souscripteur	souscripteur	Ncbms-		
souscripteurs	souscripteur	Ncbmp-		
sous-traitant	sous-traitant	Ncbms-		
sous-traitants	sous-traitant	Ncbmp-		
soutier	soutier	Ncbms-		
soutiers	soutier	Ncbmp-		
spationaute	spationaute	Ncbms-		
spationautes	spationaute	Ncbmp-		
spécialiste	spécialiste	Ncbms-		
spécialistes	spécialiste	Ncbmp-		
spectographiste	spectographiste	Ncbms-		
spectographistes	spectographiste	Ncbmp-		
spéléologue	spéléologue	Ncbms-		
spéléologues	spéléologue	Ncbmp-		
spéléonaute	spéléonaute	Ncbms-		
spéléonautes	spéléonaute	Ncbmp-		
sportif	sportif	Ncbms-		
sportifs	sportif	Ncbmp-		
sprayeur	sprayeur	Ncbms-		
sprayeurs	sprayeur	Ncbmp-		
staffeur	staffeur	Ncbms-		
staffeurs	staffeur	Ncbmp-		
stagiaire	stagiaire	Ncbms-		
stagiaires	stagiaire	Ncbmp-		
standardiste	standardiste	Ncbms-		
standardistes	standardiste	Ncbmp-		
statigraphe	statigraphe	Ncbms-		
statigraphes	statigraphe	Ncbmp-		
statisticien	statisticien	Ncbms-		
statisticiens	statisticien	Ncbmp-		
statuaire	statuaire	Ncbms-		
statuaires	statuaire	Ncbmp-		
stémiste	stémiste	Ncbms-		
stémistes	stémiste	Ncbmp-		
sténo*	sténo*	Ncbms-		
sténo*s	sténo*	Ncbmp-		
sténodactylographe*	sténodactylographe*	Ncbms-		
sténodactylographe*s	sténodactylographe*	Ncbmp-		
sténographe	sténographe	Ncbms-		
sténographes	sténographe	Ncbmp-		
sténotypiste	sténotypiste	Ncbms-		
sténotypistes	sténotypiste	Ncbmp-		
stérilisateur	stérilisateur	Ncbms-		
stérilisateurs	stérilisateur	Ncbmp-		
steward	steward	Ncbms-		
stewards	steward	Ncbmp-		
stomatologiste	stomatologiste	Ncbms-		
stomatologistes	stomatologiste	Ncbmp-		
stomatologue	stomatologue	Ncbms-		
stomatologues	stomatologue	Ncbmp-		
stoppeur	stoppeur	Ncbms-		
stoppeurs	stoppeur	Ncbmp-		
storiste	storiste	Ncbms-		
storistes	storiste	Ncbmp-		
stratifieur	stratifieur	Ncbms-		
stratifieurs	stratifieur	Ncbmp-		
stripteaseur	stripteaseur	Ncbms-		
stripteaseurs	stripteaseur	Ncbmp-		
stucateur	stucateur	Ncbms-		
stucateurs	stucateur	Ncbmp-		
stylicien*	stylicien*	Ncbms-		
stylicien*s	stylicien*	Ncbmp-		
styliste	styliste	Ncbms-		
stylistes	styliste	Ncbmp-		
substitut	substitut	Ncbms-		
substituts	substitut	Ncbmp-		
suiveur	suiveur	Ncbms-		
suiveurs	suiveur	Ncbmp-		
sujet	sujet	Ncbms-		
sujets	sujet	Ncbmp-		
supérieur	supérieur	Ncbms-		
supérieurs	supérieur	Ncbmp-		
superviseur	superviseur	Ncbms-		
superviseurs	superviseur	Ncbmp-		
suppléant	suppléant	Ncbms-		
suppléants	suppléant	Ncbmp-		
supporteur	supporteur	Ncbms-		
supporteurs	supporteur	Ncbmp-		
surfaceur	surfaceur	Ncbms-		
surfaceurs	surfaceur	Ncbmp-		
surfeur	surfeur	Ncbms-		
surfeurs	surfeur	Ncbmp-		
surfileur	surfileur	Ncbms-		
surfileurs	surfileur	Ncbmp-		
surjeteur	surjeteur	Ncbms-		
surjeteurs	surjeteur	Ncbmp-		
surnuméraire	surnuméraire	Ncbms-		
surnuméraires	surnuméraire	Ncbmp-		
surveillant	surveillant	Ncbms-		
surveillants	surveillant	Ncbmp-		
survideur	survideur	Ncbms-		
survideurs	survideur	Ncbmp-		
sylviculteur	sylviculteur	Ncbms-		
sylviculteurs	sylviculteur	Ncbmp-		
syndic	syndic	Ncbms-		
syndics	syndic	Ncbmp-		
synthétiseur	synthétiseur	Ncbms-		
synthétiseurs	synthétiseur	Ncbmp-		
tabaculteur	tabaculteur	Ncbms-		
tabaculteurs	tabaculteur	Ncbmp-		
tableauteur	tableauteur	Ncbms-		
tableauteurs	tableauteur	Ncbmp-		
tableautiste	tableautiste	Ncbms-		
tableautistes	tableautiste	Ncbmp-		
tabletier	tabletier	Ncbms-		
tabletiers	tabletier	Ncbmp-		
tâcheron	tâcheron	Ncbms-		
tâcherons	tâcheron	Ncbmp-		
taillandier	taillandier	Ncbms-		
taillandiers	taillandier	Ncbmp-		
taille-doucier	taille-doucier	Ncbms-		
taille-douciers	taille-doucier	Ncbmp-		
tailleur	tailleur	Ncbms-		
tailleurs	tailleur	Ncbmp-		
takariste	takariste	Ncbms-		
takaristes	takariste	Ncbmp-		
talonneur	talonneur	Ncbms-		
talonneurs	talonneur	Ncbmp-		
tamboureur	tamboureur	Ncbms-		
tamboureurs	tamboureur	Ncbmp-		
tamisier	tamisier	Ncbms-		
tamisiers	tamisier	Ncbmp-		
tampographe	tampographe	Ncbms-		
tampographes	tampographe	Ncbmp-		
tanneur	tanneur	Ncbms-		
tanneurs	tanneur	Ncbmp-		
tapisseur	tapisseur	Ncbms-		
tapisseurs	tapisseur	Ncbmp-		
tapissier	tapissier	Ncbms-		
tapissiers	tapissier	Ncbmp-		
taraudeur	taraudeur	Ncbms-		
taraudeurs	taraudeur	Ncbmp-		
tarifeur	tarifeur	Ncbms-		
tarifeurs	tarifeur	Ncbmp-		
tarificateur	tarificateur	Ncbms-		
tarificateurs	tarificateur	Ncbmp-		
tatoueur	tatoueur	Ncbms-		
tatoueurs	tatoueur	Ncbmp-		
taupier	taupier	Ncbms-		
taupiers	taupier	Ncbmp-		
taxateur	taxateur	Ncbms-		
taxateurs	taxateur	Ncbmp-		
taxidermiste	taxidermiste	Ncbms-		
taxidermistes	taxidermiste	Ncbmp-		
technicien	technicien	Ncbms-		
techniciens	technicien	Ncbmp-		
techniverrier	techniverrier	Ncbms-		
techniverriers	techniverrier	Ncbmp-		
technologiste	technologiste	Ncbms-		
technologistes	technologiste	Ncbmp-		
technologue	technologue	Ncbms-		
technologues	technologue	Ncbmp-		
tecticien	tecticien	Ncbms-		
tecticiens	tecticien	Ncbmp-		
tectonicien	tectonicien	Ncbms-		
tectoniciens	tectonicien	Ncbmp-		
teinturier	teinturier	Ncbms-		
teinturiers	teinturier	Ncbmp-		
téléacteur	téléacteur	Ncbms-		
téléacteurs	téléacteur	Ncbmp-		
télédétecteur	télédétecteur	Ncbms-		
télédétecteurs	télédétecteur	Ncbmp-		
télégraphiste	télégraphiste	Ncbms-		
télégraphistes	télégraphiste	Ncbmp-		
télématicien	télématicien	Ncbms-		
télématiciens	télématicien	Ncbmp-		
téléphoniste	téléphoniste	Ncbms-		
téléphonistes	téléphoniste	Ncbmp-		
téléprospecteur	téléprospecteur	Ncbms-		
téléprospecteurs	téléprospecteur	Ncbmp-		
télétypiste	télétypiste	Ncbms-		
télétypistes	télétypiste	Ncbmp-		
télévendeur	télévendeur	Ncbms-		
télévendeurs	télévendeur	Ncbmp-		
télexiste	télexiste	Ncbms-		
télexistes	télexiste	Ncbmp-		
telquelleur	telquelleur	Ncbms-		
telquelleurs	telquelleur	Ncbmp-		
témoin	témoin	Ncbms-		
témoins	témoin	Ncbmp-		
tenancier	tenancier	Ncbms-		
tenanciers	tenancier	Ncbmp-		
teneur	teneur	Ncbms-		
teneurs	teneur	Ncbmp-		
terminologue	terminologue	Ncbms-		
terminologues	terminologue	Ncbmp-		
terrassier	terrassier	Ncbms-		
terrassiers	terrassier	Ncbmp-		
tertiaire	tertiaire	Ncbms-		
tertiaires	tertiaire	Ncbmp-		
testeur	testeur	Ncbms-		
testeurs	testeur	Ncbmp-		
thanatologue	thanatologue	Ncbms-		
thanatologues	thanatologue	Ncbmp-		
thanatopracteur	thanatopracteur	Ncbms-		
thanatopracteurs	thanatopracteur	Ncbmp-		
théâtrologue	théâtrologue	Ncbms-		
théâtrologues	théâtrologue	Ncbmp-		
théologien	théologien	Ncbms-		
théologiens	théologien	Ncbmp-		
thérapeute	thérapeute	Ncbms-		
thérapeutes	thérapeute	Ncbmp-		
thermicien	thermicien	Ncbms-		
thermiciens	thermicien	Ncbmp-		
tickettier	tickettier	Ncbms-		
tickettiers	tickettier	Ncbmp-		
tierceur	tierceur	Ncbms-		
tierceurs	tierceur	Ncbmp-		
timbalier	timbalier	Ncbms-		
timbaliers	timbalier	Ncbmp-		
timbreur	timbreur	Ncbms-		
timbreurs	timbreur	Ncbmp-		
timonier	timonier	Ncbms-		
timoniers	timonier	Ncbmp-		
tireur	tireur	Ncbms-		
tireurs	tireur	Ncbmp-		
tiseur	tiseur	Ncbms-		
tiseurs	tiseur	Ncbmp-		
tisserand	tisserand	Ncbms-		
tisserands	tisserand	Ncbmp-		
tisseur	tisseur	Ncbms-		
tisseurs	tisseur	Ncbmp-		
titreur	titreur	Ncbms-		
titreurs	titreur	Ncbmp-		
titrier	titrier	Ncbms-		
titriers	titrier	Ncbmp-		
titulaire	titulaire	Ncbms-		
titulaires	titulaire	Ncbmp-		
toiletteur	toiletteur	Ncbms-		
toiletteurs	toiletteur	Ncbmp-		
toileur	toileur	Ncbms-		
toileurs	toileur	Ncbmp-		
toilier	toilier	Ncbms-		
toiliers	toilier	Ncbmp-		
toiliste	toiliste	Ncbms-		
toilistes	toiliste	Ncbmp-		
tôlier	tôlier	Ncbms-		
tôliers	tôlier	Ncbmp-		
tondeur	tondeur	Ncbms-		
tondeurs	tondeur	Ncbmp-		
tonnelier	tonnelier	Ncbms-		
tonneliers	tonnelier	Ncbmp-		
topographe	topographe	Ncbms-		
topographes	topographe	Ncbmp-		
topomètre	topomètre	Ncbms-		
topomètres	topomètre	Ncbmp-		
tordeur	tordeur	Ncbms-		
tordeurs	tordeur	Ncbmp-		
tordonneur	tordonneur	Ncbms-		
tordonneurs	tordonneur	Ncbmp-		
toréador	toréador	Ncbms-		
toréadors	toréador	Ncbmp-		
torero	torero	Ncbms-		
toreros	torero	Ncbmp-		
torero	torero	Ncbms-		
toreros	torero	Ncbmp-		
torréfacteur	torréfacteur	Ncbms-		
torréfacteurs	torréfacteur	Ncbmp-		
torsadeur	torsadeur	Ncbms-		
torsadeurs	torsadeur	Ncbmp-		
toupilleur	toupilleur	Ncbms-		
toupilleurs	toupilleur	Ncbmp-		
tourbier	tourbier	Ncbms-		
tourbiers	tourbier	Ncbmp-		
tourier	tourier	Ncbms-		
touriers	tourier	Ncbmp-		
tournant	tournant	Ncbms-		
tournants	tournant	Ncbmp-		
tourneur	tourneur	Ncbms-		
tourneurs	tourneur	Ncbmp-		
tour opérateur	tour opérateur	Ncbms-		
tour opérateurs	tour opérateur	Ncbmp-		
toxicologue	toxicologue	Ncbms-		
toxicologues	toxicologue	Ncbmp-		
traceur	traceur	Ncbms-		
traceurs	traceur	Ncbmp-		
tractiste	tractiste	Ncbms-		
tractistes	tractiste	Ncbmp-		
traducteur	traducteur	Ncbms-		
traducteurs	traducteur	Ncbmp-		
tragédien	tragédien	Ncbms-		
tragédiens	tragédien	Ncbmp-		
traiteur	traiteur	Ncbms-		
traiteurs	traiteur	Ncbmp-		
trameur	trameur	Ncbms-		
trameurs	trameur	Ncbmp-		
traminot	traminot	Ncbms-		
traminots	traminot	Ncbmp-		
trancheur	trancheur	Ncbms-		
trancheurs	trancheur	Ncbmp-		
transfériste	transfériste	Ncbms-		
transféristes	transfériste	Ncbmp-		
transformiste	transformiste	Ncbms-		
transformistes	transformiste	Ncbmp-		
transitaire	transitaire	Ncbms-		
transitaires	transitaire	Ncbmp-		
translaticien	translaticien	Ncbms-		
translaticiens	translaticien	Ncbmp-		
transporteur	transporteur	Ncbms-		
transporteurs	transporteur	Ncbmp-		
trapéziste	trapéziste	Ncbms-		
trapézistes	trapéziste	Ncbmp-		
trappeur	trappeur	Ncbms-		
trappeurs	trappeur	Ncbmp-		
trappiste	trappiste	Ncbms-		
trappistes	trappiste	Ncbmp-		
traumatologiste	traumatologiste	Ncbms-		
traumatologistes	traumatologiste	Ncbmp-		
travailleur	travailleur	Ncbms-		
travailleurs	travailleur	Ncbmp-		
trayeur	trayeur	Ncbms-		
trayeurs	trayeur	Ncbmp-		
tréfileur	tréfileur	Ncbms-		
tréfileurs	tréfileur	Ncbmp-		
treillageur	treillageur	Ncbms-		
treillageurs	treillageur	Ncbmp-		
trekkeur	trekkeur	Ncbms-		
trekkeurs	trekkeur	Ncbmp-		
trempeur	trempeur	Ncbms-		
trempeurs	trempeur	Ncbmp-		
trésorier	trésorier	Ncbms-		
trésoriers	trésorier	Ncbmp-		
tresseur	tresseur	Ncbms-		
tresseurs	tresseur	Ncbmp-		
treuilliste	treuilliste	Ncbms-		
treuillistes	treuilliste	Ncbmp-		
tricoteur	tricoteur	Ncbms-		
tricoteurs	tricoteur	Ncbmp-		
trieur	trieur	Ncbms-		
trieurs	trieur	Ncbmp-		
tripier	tripier	Ncbms-		
tripiers	tripier	Ncbmp-		
troisième	troisième	Ncbms-		
troisièmes	troisième	Ncbmp-		
tromboniste	tromboniste	Ncbms-		
trombonistes	tromboniste	Ncbmp-		
trompette	trompette	Ncbms-		
trompettes	trompette	Ncbmp-		
trompettiste	trompettiste	Ncbms-		
trompettistes	trompettiste	Ncbmp-		
tronçonneur	tronçonneur	Ncbms-		
tronçonneurs	tronçonneur	Ncbmp-		
trufficulteur	trufficulteur	Ncbms-		
trufficulteurs	trufficulteur	Ncbmp-		
truiticulteur	truiticulteur	Ncbms-		
truiticulteurs	truiticulteur	Ncbmp-		
truquiste	truquiste	Ncbms-		
truquistes	truquiste	Ncbmp-		
tuba	tuba	Ncbms-		
tubas	tuba	Ncbmp-		
tueur	tueur	Ncbms-		
tueurs	tueur	Ncbmp-		
tuilier	tuilier	Ncbms-		
tuiliers	tuilier	Ncbmp-		
tulliste	tulliste	Ncbms-		
tullistes	tulliste	Ncbmp-		
turbineur	turbineur	Ncbms-		
turbineurs	turbineur	Ncbmp-		
turbinier	turbinier	Ncbms-		
turbiniers	turbinier	Ncbmp-		
turfiste	turfiste	Ncbms-		
turfistes	turfiste	Ncbmp-		
tuteur	tuteur	Ncbms-		
tuteurs	tuteur	Ncbmp-		
tuttiste	tuttiste	Ncbms-		
tuttistes	tuttiste	Ncbmp-		
tuyauteur	tuyauteur	Ncbms-		
tuyauteurs	tuyauteur	Ncbmp-		
typeur	typeur	Ncbms-		
typeurs	typeur	Ncbmp-		
typographe	typographe	Ncbms-		
typographes	typographe	Ncbmp-		
typomonteur	typomonteur	Ncbms-		
typomonteurs	typomonteur	Ncbmp-		
ufologue	ufologue	Ncbms-		
ufologues	ufologue	Ncbmp-		
ulmiste	ulmiste	Ncbms-		
ulmistes	ulmiste	Ncbmp-		
universitaire	universitaire	Ncbms-		
universitaires	universitaire	Ncbmp-		
upérisateur	upérisateur	Ncbms-		
upérisateurs	upérisateur	Ncbmp-		
urbaniste	urbaniste	Ncbms-		
urbanistes	urbaniste	Ncbmp-		
urbanologue	urbanologue	Ncbms-		
urbanologues	urbanologue	Ncbmp-		
urgentiste	urgentiste	Ncbms-		
urgentistes	urgentiste	Ncbmp-		
urologue	urologue	Ncbms-		
urologues	urologue	Ncbmp-		
usager	usager	Ncbms-		
usagers	usager	Ncbmp-		
usineur	usineur	Ncbms-		
usineurs	usineur	Ncbmp-		
utilisateur	utilisateur	Ncbms-		
utilisateurs	utilisateur	Ncbmp-		
vacataire	vacataire	Ncbms-		
vacataires	vacataire	Ncbmp-		
vacher	vacher	Ncbms-		
vachers	vacher	Ncbmp-		
vaguemestre	vaguemestre	Ncbms-		
vaguemestres	vaguemestre	Ncbmp-		
vaisselier	vaisselier	Ncbms-		
vaisseliers	vaisselier	Ncbmp-		
valet*	valet*	Ncbms-		
valet*s	valet*	Ncbmp-		
valet de chambre*	valet de chambre*	Ncbms-		
valet de chambre*s	valet de chambre*	Ncbmp-		
vannier	vannier	Ncbms-		
vanniers	vannier	Ncbmp-		
vaporisateur	vaporisateur	Ncbms-		
vaporisateurs	vaporisateur	Ncbmp-		
varitypiste	varitypiste	Ncbms-		
varitypistes	varitypiste	Ncbmp-		
varouleur	varouleur	Ncbms-		
varouleurs	varouleur	Ncbmp-		
veilleur	veilleur	Ncbms-		
veilleurs	veilleur	Ncbmp-		
velouteur	velouteur	Ncbms-		
velouteurs	velouteur	Ncbmp-		
veloutier	veloutier	Ncbms-		
veloutiers	veloutier	Ncbmp-		
vendangeur	vendangeur	Ncbms-		
vendangeurs	vendangeur	Ncbmp-		
vendeur	vendeur	Ncbms-		
vendeurs	vendeur	Ncbmp-		
vénéréologiste	vénéréologiste	Ncbms-		
vénéréologistes	vénéréologiste	Ncbmp-		
vénériculteur	vénériculteur	Ncbms-		
vénériculteurs	vénériculteur	Ncbmp-		
vénérologiste	vénérologiste	Ncbms-		
vénérologistes	vénérologiste	Ncbmp-		
vénérologue	vénérologue	Ncbms-		
vénérologues	vénérologue	Ncbmp-		
ventriloque	ventriloque	Ncbms-		
ventriloques	ventriloque	Ncbmp-		
vergetier	vergetier	Ncbms-		
vergetiers	vergetier	Ncbmp-		
vérificateur	vérificateur	Ncbms-		
vérificateurs	vérificateur	Ncbmp-		
vérifieur	vérifieur	Ncbms-		
vérifieurs	vérifieur	Ncbmp-		
vernisseur	vernisseur	Ncbms-		
vernisseurs	vernisseur	Ncbmp-		
verrier	verrier	Ncbms-		
verriers	verrier	Ncbmp-		
vestiairiste	vestiairiste	Ncbms-		
vestiairistes	vestiairiste	Ncbmp-		
vétéran	vétéran	Ncbms-		
vétérans	vétéran	Ncbmp-		
vétérinaire	vétérinaire	Ncbms-		
vétérinaires	vétérinaire	Ncbmp-		
vibraphoniste	vibraphoniste	Ncbms-		
vibraphonistes	vibraphoniste	Ncbmp-		
vice	vice	Ncbms-		
vices	vice	Ncbmp-		
vidangeur	vidangeur	Ncbms-		
vidangeurs	vidangeur	Ncbmp-		
vidéaste	vidéaste	Ncbms-		
vidéastes	vidéaste	Ncbmp-		
vidéographiste	vidéographiste	Ncbms-		
vidéographistes	vidéographiste	Ncbmp-		
videur	videur	Ncbms-		
videurs	videur	Ncbmp-		
vigneron	vigneron	Ncbms-		
vignerons	vigneron	Ncbmp-		
vinaigrier	vinaigrier	Ncbms-		
vinaigriers	vinaigrier	Ncbmp-		
violoncelliste	violoncelliste	Ncbms-		
violoncellistes	violoncelliste	Ncbmp-		
violoniste	violoniste	Ncbms-		
violonistes	violoniste	Ncbmp-		
virologiste	virologiste	Ncbms-		
virologistes	virologiste	Ncbmp-		
virologue	virologue	Ncbms-		
virologues	virologue	Ncbmp-		
visagiste	visagiste	Ncbms-		
visagistes	visagiste	Ncbmp-		
visiteur	visiteur	Ncbms-		
visiteurs	visiteur	Ncbmp-		
viticulteur	viticulteur	Ncbms-		
viticulteurs	viticulteur	Ncbmp-		
vitrailliste	vitrailliste	Ncbms-		
vitraillistes	vitrailliste	Ncbmp-		
vitrier	vitrier	Ncbms-		
vitriers	vitrier	Ncbmp-		
vitrificateur	vitrificateur	Ncbms-		
vitrificateurs	vitrificateur	Ncbmp-		
voilier	voilier	Ncbms-		
voiliers	voilier	Ncbmp-		
voiturier	voiturier	Ncbms-		
voituriers	voiturier	Ncbmp-		
volailler	volailler	Ncbms-		
volaillers	volailler	Ncbmp-		
volcanologue	volcanologue	Ncbms-		
volcanologues	volcanologue	Ncbmp-		
volleyeur	volleyeur	Ncbms-		
volleyeurs	volleyeur	Ncbmp-		
voltigeur	voltigeur	Ncbms-		
voltigeurs	voltigeur	Ncbmp-		
voyageur	voyageur	Ncbms-		
voyageurs	voyageur	Ncbmp-		
voyagiste	voyagiste	Ncbms-		
voyagistes	voyagiste	Ncbmp-		
voyant	voyant	Ncbms-		
voyants	voyant	Ncbmp-		
V.R.P.	V.R.P.	Ncbms-		
V.R.P.s	V.R.P.	Ncbmp-		
vulcanisateur	vulcanisateur	Ncbms-		
vulcanisateurs	vulcanisateur	Ncbmp-		
vulcaniseur	vulcaniseur	Ncbms-		
vulcaniseurs	vulcaniseur	Ncbmp-		
vulcanologue*	vulcanologue*	Ncbms-		
vulcanologue*s	vulcanologue*	Ncbmp-		
wagonnier	wagonnier	Ncbms-		
wagonniers	wagonnier	Ncbmp-		
xylographe	xylographe	Ncbms-		
xylographes	xylographe	Ncbmp-		
xylophoniste	xylophoniste	Ncbms-		
xylophonistes	xylophoniste	Ncbmp-		
yogi	yogi	Ncbms-		
yogis	yogi	Ncbmp-		
zingueur	zingueur	Ncbms-		
zingueurs	zingueur	Ncbmp-		
zoneur	zoneur	Ncbms-		
zoneurs	zoneur	Ncbmp-		
zoologiste	zoologiste	Ncbms-		
zoologistes	zoologiste	Ncbmp-		
zootechnicien	zootechnicien	Ncbms-		
zootechniciens	zootechnicien	Ncbmp-		
