NONE_1	L_NONE_1
1	L_1
2	L_2
3	L_3
ACC	L_ACC
ACT	L_ACT
ADJ	L_ADJ
ADV	L_ADV
AFFIX	L_AFFIX
COND_PASS	L_COND_PASS
COND_PRES	L_COND_PRES
CONJ	L_CONJ
DET	L_DET
DETERMINEUR	L_DETERMINEUR
DIVERS	L_DIVERS
DIVERS_DATE	L_DIVERS_DATE
DIVERS_PARTICULE	L_DIVERS_PARTICULE
DUEL	L_DUEL
FEM	L_FEM
FUTUR	L_FUTUR
FUTUR_ANT	L_FUTUR_ANT
GEN	L_GEN
IMP	L_IMP
IMPERS	L_IMPERS
IMPFT	L_IMPFT
INTERJ	L_INTERJ
INTRANS	L_INTRANS
MASC	L_MASC
NC	L_NC
NEUTRE	L_NEUTRE
NOM	L_NOM
NOMBRE	L_NOMBRE
NP	L_NP
NUMBER	L_NUMBER
PART	L_PART
PARTICULE	L_PARTICULE
PASS	L_PASS
PASS_ANT	L_PASS_ANT
PC	L_PC
PLUR	L_PLUR
PONCTU	L_PONCTU
PQPFT	L_PQPFT
PREP	L_PREP
PRES	L_PRES
PRETERIT	L_PRETERIT
PRON	L_PRON
PRONOMINAL	L_PRONOMINAL
SING	L_SING
SPECIFICATIF	L_SPECIFICATIF
SUK	L_SUK
TRANS	L_TRANS
V	L_V
NC1	L_GE_NOM_DANS_MOT_COMPOSE_POSITION_INITIALE
NC2	L_GE_NOM_DANS_MOT_COMPOSE_POSITION_INTERMEDIAIRE
NC3	L_GE_NOM_DANS_MOT_COMPOSE_POSITION_FINALE
Nad1	L_GE_ADJ_NOMINAL_SANS_DET_NOMINATIF
Nad2	L_GE_ADJ_NOMINAL_SANS_DET_GENITIF
Nad3	L_GE_ADJ_NOMINAL_SANS_DET_DATIF
Nad4	L_GE_ADJ_NOMINAL_SANS_DET_ACCUSATIF
Nag1	L_GE_ADJ_NOMINAL_GENERAL_NOMINATIF
Nag2	L_GE_ADJ_NOMINAL_GENERAL_GENITIF
Nag3	L_GE_ADJ_NOMINAL_GENERAL_DATIF
Nag4	L_GE_ADJ_NOMINAL_GENERAL_ACCUSATIF
Nan1	L_GE_ADJ_NOMINAL_COORDONNE_A_DET_NOM_NOMINATIF
Nan2	L_GE_ADJ_NOMINAL_COORDONNE_A_DET_NOM_GENITIF
Nan3	L_GE_ADJ_NOMINAL_COORDONNE_A_DET_NOM_DATIF
Nan4	L_GE_ADJ_NOMINAL_COORDONNE_A_DET_NOM_ACCUSATIF
Nap1	L_GE_ADJ_NOMINAL_APPOSITION_A_NC_NOMINATIF
Nap2	L_GE_ADJ_NOMINAL_APPOSITION_A_NC_GENITIF
Nap3	L_GE_ADJ_NOMINAL_APPOSITION_A_NC_DATIF
Nap4	L_GE_ADJ_NOMINAL_APPOSITION_A_NC_ACCUSATIF
Nca-	L_GE_NOM_COMMUN_APPELLATION_DE_NP
Ncc1	L_GE_NOM_COMMUN_CLASSIFICATEUR_DE_NP_NOMINATIF
Ncc2	L_GE_NOM_COMMUN_CLASSIFICATEUR_DE_NP_GENITIF
Ncc3	L_GE_NOM_COMMUN_CLASSIFICATEUR_DE_NP_DATIF
Ncc4	L_GE_NOM_COMMUN_CLASSIFICATEUR_DE_NP_ACCUSATIF
Ncd1	L_GE_NOM_COMMUN_SANS_DET_NOMINATIF
Ncd2	L_GE_NOM_COMMUN_SANS_DET_GENITIF
Ncd3	L_GE_NOM_COMMUN_SANS_DET_DATIF
Ncd4	L_GE_NOM_COMMUN_SANS_DET_ACCUSATIF
Ncg1	L_GE_NOM_COMMUN_GENERAL_NOMINATIF
Ncg2	L_GE_NOM_COMMUN_GENERAL_GENITIF
Ncg3	L_GE_NOM_COMMUN_GENERAL_DATIF
Ncg4	L_GE_NOM_COMMUN_GENERAL_ACCUSATIF
Ncge	L_GE_NOM_COMMUN_GENERAL_GENITIF_PRENOMINAL
Ncgo	L_GE_NOM_COMMUN_GENERAL_GENITIF_POSTNOMINAL
Nch1	L_GE_NOM_COMMUN_TRONQUE_GAUCHE_NOMINATIF
Nch2	L_GE_NOM_COMMUN_TRONQUE_GAUCHE_GENITIF
Nch3	L_GE_NOM_COMMUN_TRONQUE_GAUCHE_DATIF
Nch4	L_GE_NOM_COMMUN_TRONQUE_GAUCHE_ACCUSATIF
Ncj1	L_GE_NOM_COMMUN_JOUR_NOMINATIF
Ncj2	L_GE_NOM_COMMUN_JOUR_GENITIF
Ncj3	L_GE_NOM_COMMUN_JOUR_DATIF
Ncj4	L_GE_NOM_COMMUN_JOUR_ACCUSATIF
Ncm1	L_GE_NOM_COMMUN_MOIS_NOMINATIF
Ncm2	L_GE_NOM_COMMUN_MOIS_GENITIF
Ncm3	L_GE_NOM_COMMUN_MOIS_DATIF
Ncm4	L_GE_NOM_COMMUN_MOIS_ACCUSATIF
Ncn1	L_GE_NOM_COMMUN_COORDONNE_A_DET_NOM_NOMINATIF
Ncn2	L_GE_NOM_COMMUN_COORDONNE_A_DET_NOM_GENITIF
Ncn3	L_GE_NOM_COMMUN_COORDONNE_A_DET_NOM_DATIF
Ncn4	L_GE_NOM_COMMUN_COORDONNE_A_DET_NOM_ACCUSATIF
Ncp1	L_GE_NOM_COMMUN_APPOSITION_A_NC_NOMINATIF
Ncp2	L_GE_NOM_COMMUN_APPOSITION_A_NC_GENITIF
Ncp3	L_GE_NOM_COMMUN_APPOSITION_A_NC_DATIF
Ncp4	L_GE_NOM_COMMUN_APPOSITION_A_NC_ACCUSATIF
Ncr-	L_GE_NOM_COMMUN_TRONQUE_DROITE
Ncu1	L_GE_NOM_COMMUN_UNITE_DE_MESURE_NOMINATIF
Ncu2	L_GE_NOM_COMMUN_UNITE_DE_MESURE_GENITIF
Ncu3	L_GE_NOM_COMMUN_UNITE_DE_MESURE_DATIF
Ncu4	L_GE_NOM_COMMUN_UNITE_DE_MESURE_ACCUSATIF
Nid1	L_GE_INF_NOMINAL_SANS_DET_NOMINATIF
Nid2	L_GE_INF_NOMINAL_SANS_DET_GENITIF
Nid3	L_GE_INF_NOMINAL_SANS_DET_DATIF
Nid4	L_GE_INF_NOMINAL_SANS_DET_ACCUSATIF
Nig1	L_GE_INF_NOMINAL_GENERAL_NOMINATIF
Nig2	L_GE_INF_NOMINAL_GENERAL_GENITIF
Nig3	L_GE_INF_NOMINAL_GENERAL_DATIF
Nig4	L_GE_INF_NOMINAL_GENERAL_ACCUSATIF
Nin1	L_GE_INF_NOMINAL_COORDONNE_A_DET_NOM_NOMINATIF
Nin2	L_GE_INF_NOMINAL_COORDONNE_A_DET_NOM_GENITIF
Nin3	L_GE_INF_NOMINAL_COORDONNE_A_DET_NOM_DATIF
Nin4	L_GE_INF_NOMINAL_COORDONNE_A_DET_NOM_ACCUSATIF
Nip1	L_GE_INF_NOMINAL_APPOSITION_A_NC_NOMINATIF
Nip2	L_GE_INF_NOMINAL_APPOSITION_A_NC_GENITIF
Nip3	L_GE_INF_NOMINAL_APPOSITION_A_NC_DATIF
Nip4	L_GE_INF_NOMINAL_APPOSITION_A_NC_ACCUSATIF
Np-1	L_GE_NOM_PROPRE_NOMINATIF
Np-2	L_GE_NOM_PROPRE_GENITIF
Np-3	L_GE_NOM_PROPRE_DATIF
Np-4	L_GE_NOM_PROPRE_ACCUSATIF
Np-e	L_GE_NOM_PROPRE_GENITIF_PRENOMINAL
Np-o	L_GE_NOM_PROPRE_GENITIF_POSTNOMINAL
Dn1	L_GE_DETERMINANT_AVANT_GN_NOMINATIF
Dn2	L_GE_DETERMINANT_AVANT_GN_GENITIF
Dn3	L_GE_DETERMINANT_AVANT_GN_DATIF
Dn4	L_GE_DETERMINANT_AVANT_GN_ACCUSATIF
Ds1	L_GE_DETERMINANT_INTRO_SUB_NOMINATIF
Ds2	L_GE_DETERMINANT_INTRO_SUB_GENITIF
Ds3	L_GE_DETERMINANT_INTRO_SUB_DATIF
Ds4	L_GE_DETERMINANT_INTRO_SUB_ACCUSATIF
Pa--	L_GE_PRONOM_ADVERBIAL
Pd-1	L_GE_PRONOM_DEPENDANT_NOMINATIF
Pd-2	L_GE_PRONOM_DEPENDANT_GENITIF
Pd-3	L_GE_PRONOM_DEPENDANT_DATIF
Pd-4	L_GE_PRONOM_DEPENDANT_ACCUSATIF
Pe--	L_GE_PRONOM_PLUS_PREPOSITION
Pf-3	L_GE_PRONOM_REFLECHI/RECIPROQUE_DATIF
Pf-4	L_GE_PRONOM_REFLECHI/RECIPROQUE_ACCUSATIF
Pl-1	L_GE_PRONOM_IMPERSONNEL_NOMINATIF
Plz1	L_GE_PRONOM_IMPERSONNEL_SUJET_ZERO_NOMINATIF
Pp-1	L_GE_PRONOM_PERSONNEL/DEMONSTRATIF/POSSESSIF/INDEFINI/NEGATIF_NOMINATIF
Pp-2	L_GE_PRONOM_PERSONNEL/DEMONSTRATIF/POSSESSIF/INDEFINI/NEGATIF_GENITIF
Pp-3	L_GE_PRONOM_PERSONNEL/DEMONSTRATIF/POSSESSIF/INDEFINI/NEGATIF_DATIF
Pp-4	L_GE_PRONOM_PERSONNEL/DEMONSTRATIF/POSSESSIF/INDEFINI/NEGATIF_ACCUSATIF
Pq--	L_GE_PRONOM_QUANTIFICATEUR
Pq-1	L_GE_PRONOM_QUANTIFICATEUR_NOMINATIF
Pq-2	L_GE_PRONOM_QUANTIFICATEUR_GENITIF
Pq-3	L_GE_PRONOM_QUANTIFICATEUR_DATIF
Pq-4	L_GE_PRONOM_QUANTIFICATEUR_ACCUSATIF
Pri-	L_GE_PRONOM_RELATIF/INTERROGATIF_INTRO_INTERROGATION_DIRECTE_ADVERBIAL
Pri1	L_GE_PRONOM_RELATIF/INTERROGATIF_INTRO_INTERROGATION_DIRECTE_NOMINATIF
Pri2	L_GE_PRONOM_RELATIF/INTERROGATIF_INTRO_INTERROGATION_DIRECTE_GENITIF
Pri3	L_GE_PRONOM_RELATIF/INTERROGATIF_INTRO_INTERROGATION_DIRECTE_DATIF
Pri4	L_GE_PRONOM_RELATIF/INTERROGATIF_INTRO_INTERROGATION_DIRECTE_ACCUSATIF
Prs-	L_GE_PRONOM_RELATIF/INTERROGATIF_INTRO_SUB_ADVERBIAL
Prs1	L_GE_PRONOM_RELATIF/INTERROGATIF_INTRO_SUB_NOMINATIF
Prs2	L_GE_PRONOM_RELATIF/INTERROGATIF_INTRO_SUB_GENITIF
Prs3	L_GE_PRONOM_RELATIF/INTERROGATIF_INTRO_SUB_DATIF
Prs4	L_GE_PRONOM_RELATIF/INTERROGATIF_INTRO_SUB_ACCUSATIF
AC1	L_GE_ADJECTIF_DANS_MOT_COMPOSE_POSITION_INITIALE
AC2	L_GE_ADJECTIF_DANS_MOT_COMPOSE_POSITION_INTERMEDIAIRE
AC3	L_GE_ADJECTIF_DANS_MOT_COMPOSE_POSITION_FINALE
Aedk1	L_GE_ADJECTIF_PARTICIPE_PASSE_DETACHE_COMPARATIF_NOMINATIF
Aedk2	L_GE_ADJECTIF_PARTICIPE_PASSE_DETACHE_COMPARATIF_GENITIF
Aedk3	L_GE_ADJECTIF_PARTICIPE_PASSE_DETACHE_COMPARATIF_DATIF
Aedk4	L_GE_ADJECTIF_PARTICIPE_PASSE_DETACHE_COMPARATIF_ACCUSATIF
Aedo1	L_GE_ADJECTIF_PARTICIPE_PASSE_DETACHE_POSITIF_NOMINATIF
Aedo2	L_GE_ADJECTIF_PARTICIPE_PASSE_DETACHE_POSITIF_GENITIF
Aedo3	L_GE_ADJECTIF_PARTICIPE_PASSE_DETACHE_POSITIF_DATIF
Aedo4	L_GE_ADJECTIF_PARTICIPE_PASSE_DETACHE_POSITIF_ACCUSATIF
Aeds1	L_GE_ADJECTIF_PARTICIPE_PASSE_DETACHE_SUPERLATIF_NOMINATIF
Aeds2	L_GE_ADJECTIF_PARTICIPE_PASSE_DETACHE_SUPERLATIF_GENITIF
Aeds3	L_GE_ADJECTIF_PARTICIPE_PASSE_DETACHE_SUPERLATIF_DATIF
Aeds4	L_GE_ADJECTIF_PARTICIPE_PASSE_DETACHE_SUPERLATIF_ACCUSATIF
Aeek-	L_GE_ADJECTIF_PARTICIPE_PASSE_PREDICATIF_ELLIPSE_VERBALE_COMPARATIF
Aeeo-	L_GE_ADJECTIF_PARTICIPE_PASSE_PREDICATIF_ELLIPSE_VERBALE_POSITIF
Aees-	L_GE_ADJECTIF_PARTICIPE_PASSE_PREDICATIF_ELLIPSE_VERBALE_SUPERLATIF
Aehk1	L_GE_ADJECTIF_PARTICIPE_PASSE_APPOSITION_A_GN_COMPARATIF_NOMINATIF
Aehk2	L_GE_ADJECTIF_PARTICIPE_PASSE_APPOSITION_A_GN_COMPARATIF_GENITIF
Aehk3	L_GE_ADJECTIF_PARTICIPE_PASSE_APPOSITION_A_GN_COMPARATIF_DATIF
Aehk4	L_GE_ADJECTIF_PARTICIPE_PASSE_APPOSITION_A_GN_COMPARATIF_ACCUSATIF
Aeho1	L_GE_ADJECTIF_PARTICIPE_PASSE_APPOSITION_A_GN_POSITIF_NOMINATIF
Aeho2	L_GE_ADJECTIF_PARTICIPE_PASSE_APPOSITION_A_GN_POSITIF_GENITIF
Aeho3	L_GE_ADJECTIF_PARTICIPE_PASSE_APPOSITION_A_GN_POSITIF_DATIF
Aeho4	L_GE_ADJECTIF_PARTICIPE_PASSE_APPOSITION_A_GN_POSITIF_ACCUSATIF
Aehs1	L_GE_ADJECTIF_PARTICIPE_PASSE_APPOSITION_A_GN_SUPERLATIF_NOMINATIF
Aehs2	L_GE_ADJECTIF_PARTICIPE_PASSE_APPOSITION_A_GN_SUPERLATIF_GENITIF
Aehs3	L_GE_ADJECTIF_PARTICIPE_PASSE_APPOSITION_A_GN_SUPERLATIF_DATIF
Aehs4	L_GE_ADJECTIF_PARTICIPE_PASSE_APPOSITION_A_GN_SUPERLATIF_ACCUSATIF
Aepk-	L_GE_ADJECTIF_PARTICIPE_PASSE_PREDICATIF_COMPARATIF
Aepo-	L_GE_ADJECTIF_PARTICIPE_PASSE_PREDICATIF_POSITIF
Aeps-	L_GE_ADJECTIF_PARTICIPE_PASSE_PREDICATIF_SUPERLATIF
Afdk1	L_GE_ADJECTIF_QUALIFICATIF_DETACHE_COMPARATIF_NOMINATIF
Afdk2	L_GE_ADJECTIF_QUALIFICATIF_DETACHE_COMPARATIF_GENITIF
Afdk3	L_GE_ADJECTIF_QUALIFICATIF_DETACHE_COMPARATIF_DATIF
Afdk4	L_GE_ADJECTIF_QUALIFICATIF_DETACHE_COMPARATIF_ACCUSATIF
Afdo1	L_GE_ADJECTIF_QUALIFICATIF_DETACHE_POSITIF_NOMINATIF
Afdo2	L_GE_ADJECTIF_QUALIFICATIF_DETACHE_POSITIF_GENITIF
Afdo3	L_GE_ADJECTIF_QUALIFICATIF_DETACHE_POSITIF_DATIF
Afdo4	L_GE_ADJECTIF_QUALIFICATIF_DETACHE_POSITIF_ACCUSATIF
Afds1	L_GE_ADJECTIF_QUALIFICATIF_DETACHE_SUPERLATIF_NOMINATIF
Afds2	L_GE_ADJECTIF_QUALIFICATIF_DETACHE_SUPERLATIF_GENITIF
Afds3	L_GE_ADJECTIF_QUALIFICATIF_DETACHE_SUPERLATIF_DATIF
Afds4	L_GE_ADJECTIF_QUALIFICATIF_DETACHE_SUPERLATIF_ACCUSATIF
Afek-	L_GE_ADJECTIF_QUALIFICATIF_PREDICATIF_ELLIPSE_VERBALE_COMPARATIF
Afeo-	L_GE_ADJECTIF_QUALIFICATIF_PREDICATIF_ELLIPSE_VERBALE_POSITIF
Afes-	L_GE_ADJECTIF_QUALIFICATIF_PREDICATIF_ELLIPSE_VERBALE_SUPERLATIF
Afhk1	L_GE_ADJECTIF_QUALIFICATIF_APPOSITION_A_GN_COMPARATIF_NOMINATIF
Afhk2	L_GE_ADJECTIF_QUALIFICATIF_APPOSITION_A_GN_COMPARATIF_GENITIF
Afhk3	L_GE_ADJECTIF_QUALIFICATIF_APPOSITION_A_GN_COMPARATIF_DATIF
Afhk4	L_GE_ADJECTIF_QUALIFICATIF_APPOSITION_A_GN_COMPARATIF_ACCUSATIF
Afho1	L_GE_ADJECTIF_QUALIFICATIF_APPOSITION_A_GN_POSITIF_NOMINATIF
Afho2	L_GE_ADJECTIF_QUALIFICATIF_APPOSITION_A_GN_POSITIF_GENITIF
Afho3	L_GE_ADJECTIF_QUALIFICATIF_APPOSITION_A_GN_POSITIF_DATIF
Afho4	L_GE_ADJECTIF_QUALIFICATIF_APPOSITION_A_GN_POSITIF_ACCUSATIF
Afhs1	L_GE_ADJECTIF_QUALIFICATIF_APPOSITION_A_GN_SUPERLATIF_NOMINATIF
Afhs2	L_GE_ADJECTIF_QUALIFICATIF_APPOSITION_A_GN_SUPERLATIF_GENITIF
Afhs3	L_GE_ADJECTIF_QUALIFICATIF_APPOSITION_A_GN_SUPERLATIF_DATIF
Afhs4	L_GE_ADJECTIF_QUALIFICATIF_APPOSITION_A_GN_SUPERLATIF_ACCUSATIF
Afpk-	L_GE_ADJECTIF_QUALIFICATIF_PREDICATIF_COMPARATIF
Afpo-	L_GE_ADJECTIF_QUALIFICATIF_PREDICATIF_POSITIF
Afps-	L_GE_ADJECTIF_QUALIFICATIF_PREDICATIF_SUPERLATIF
Akd--	L_GE_ADJECTIF_CARDINAL_DETACHE
Akd-1	L_GE_ADJECTIF_CARDINAL_DETACHE_NOMINATIF
Akd-2	L_GE_ADJECTIF_CARDINAL_DETACHE_GENITIF
Akd-3	L_GE_ADJECTIF_CARDINAL_DETACHE_DATIF
Akd-4	L_GE_ADJECTIF_CARDINAL_DETACHE_ACCUSATIF
Ake--	L_GE_ADJECTIF_CARDINAL_PREDICATIF_ELLIPSE_VERBALE
Ake-1	L_GE_ADJECTIF_CARDINAL_PREDICATIF_ELLIPSE_VERBALE_NOMINATIF
Ake-2	L_GE_ADJECTIF_CARDINAL_PREDICATIF_ELLIPSE_VERBALE_GENITIF
Ake-3	L_GE_ADJECTIF_CARDINAL_PREDICATIF_ELLIPSE_VERBALE_DATIF
Ake-4	L_GE_ADJECTIF_CARDINAL_PREDICATIF_ELLIPSE_VERBALE_ACCUSATIF
Akh--	L_GE_ADJECTIF_CARDINAL_APPOSITION_A_GN
Akh-1	L_GE_ADJECTIF_CARDINAL_APPOSITION_A_GN_NOMINATIF
Akh-2	L_GE_ADJECTIF_CARDINAL_APPOSITION_A_GN_GENITIF
Akh-3	L_GE_ADJECTIF_CARDINAL_APPOSITION_A_GN_DATIF
Akh-4	L_GE_ADJECTIF_CARDINAL_APPOSITION_A_GN_ACCUSATIF
Ako--	L_GE_ADJECTIF_CARDINAL
Ako-1	L_GE_ADJECTIF_CARDINAL_NOMINATIF
Ako-2	L_GE_ADJECTIF_CARDINAL_GENITIF
Ako-3	L_GE_ADJECTIF_CARDINAL_DATIF
Ako-4	L_GE_ADJECTIF_CARDINAL_ACCUSATIF
Akp--	L_GE_ADJECTIF_CARDINAL_PREDICATIF
Akp-1	L_GE_ADJECTIF_CARDINAL_PREDICATIF_NOMINATIF
Akp-2	L_GE_ADJECTIF_CARDINAL_PREDICATIF_GENITIF
Akp-3	L_GE_ADJECTIF_CARDINAL_PREDICATIF_DATIF
Akp-4	L_GE_ADJECTIF_CARDINAL_PREDICATIF_ACCUSATIF
Andk1	L_GE_ADJECTIF_PARTICIPE_PRESENT_DETACHE_COMPARATIF_NOMINATIF
Andk2	L_GE_ADJECTIF_PARTICIPE_PRESENT_DETACHE_COMPARATIF_GENITIF
Andk3	L_GE_ADJECTIF_PARTICIPE_PRESENT_DETACHE_COMPARATIF_DATIF
Andk4	L_GE_ADJECTIF_PARTICIPE_PRESENT_DETACHE_COMPARATIF_ACCUSATIF
Ando1	L_GE_ADJECTIF_PARTICIPE_PRESENT_DETACHE_POSITIF_NOMINATIF
Ando2	L_GE_ADJECTIF_PARTICIPE_PRESENT_DETACHE_POSITIF_GENITIF
Ando3	L_GE_ADJECTIF_PARTICIPE_PRESENT_DETACHE_POSITIF_DATIF
Ando4	L_GE_ADJECTIF_PARTICIPE_PRESENT_DETACHE_POSITIF_ACCUSATIF
Ands1	L_GE_ADJECTIF_PARTICIPE_PRESENT_DETACHE_SUPERLATIF_NOMINATIF
Ands2	L_GE_ADJECTIF_PARTICIPE_PRESENT_DETACHE_SUPERLATIF_GENITIF
Ands3	L_GE_ADJECTIF_PARTICIPE_PRESENT_DETACHE_SUPERLATIF_DATIF
Ands4	L_GE_ADJECTIF_PARTICIPE_PRESENT_DETACHE_SUPERLATIF_ACCUSATIF
Anek-	L_GE_ADJECTIF_PARTICIPE_PRESENT_PREDICATIF_ELLIPSE_VERBALE_COMPARATIF
Aneo-	L_GE_ADJECTIF_PARTICIPE_PRESENT_PREDICATIF_ELLIPSE_VERBALE_POSITIF
Anes-	L_GE_ADJECTIF_PARTICIPE_PRESENT_PREDICATIF_ELLIPSE_VERBALE_SUPERLATIF
Anhk1	L_GE_ADJECTIF_PARTICIPE_PRESENT_APPOSITION_A_GN_COMPARATIF_NOMINATIF
Anhk2	L_GE_ADJECTIF_PARTICIPE_PRESENT_APPOSITION_A_GN_COMPARATIF_GENITIF
Anhk3	L_GE_ADJECTIF_PARTICIPE_PRESENT_APPOSITION_A_GN_COMPARATIF_DATIF
Anhk4	L_GE_ADJECTIF_PARTICIPE_PRESENT_APPOSITION_A_GN_COMPARATIF_ACCUSATIF
Anho1	L_GE_ADJECTIF_PARTICIPE_PRESENT_APPOSITION_A_GN_POSITIF_NOMINATIF
Anho2	L_GE_ADJECTIF_PARTICIPE_PRESENT_APPOSITION_A_GN_POSITIF_GENITIF
Anho3	L_GE_ADJECTIF_PARTICIPE_PRESENT_APPOSITION_A_GN_POSITIF_DATIF
Anho4	L_GE_ADJECTIF_PARTICIPE_PRESENT_APPOSITION_A_GN_POSITIF_ACCUSATIF
Anhs1	L_GE_ADJECTIF_PARTICIPE_PRESENT_APPOSITION_A_GN_SUPERLATIF_NOMINATIF
Anhs2	L_GE_ADJECTIF_PARTICIPE_PRESENT_APPOSITION_A_GN_SUPERLATIF_GENITIF
Anhs3	L_GE_ADJECTIF_PARTICIPE_PRESENT_APPOSITION_A_GN_SUPERLATIF_DATIF
Anhs4	L_GE_ADJECTIF_PARTICIPE_PRESENT_APPOSITION_A_GN_SUPERLATIF_ACCUSATIF
Anpk-	L_GE_ADJECTIF_PARTICIPE_PRESENT_PREDICATIF_COMPARATIF
Anpo-	L_GE_ADJECTIF_PARTICIPE_PRESENT_PREDICATIF_POSITIF
Anps-	L_GE_ADJECTIF_PARTICIPE_PRESENT_PREDICATIF_SUPERLATIF
Aodo1	L_GE_ADJECTIF_ORDINAL_DETACHE_POSITIF_NOMINATIF
Aodo2	L_GE_ADJECTIF_ORDINAL_DETACHE_POSITIF_GENITIF
Aodo3	L_GE_ADJECTIF_ORDINAL_DETACHE_POSITIF_DATIF
Aodo4	L_GE_ADJECTIF_ORDINAL_DETACHE_POSITIF_ACCUSATIF
Aoeo-	L_GE_ADJECTIF_ORDINAL_PREDICATIF_ELLIPSE_VERBALE_POSITIF
Aoho1	L_GE_ADJECTIF_ORDINAL_APPOSITION_A_GN_POSITIF_NOMINATIF
Aoho2	L_GE_ADJECTIF_ORDINAL_APPOSITION_A_GN_POSITIF_GENITIF
Aoho3	L_GE_ADJECTIF_ORDINAL_APPOSITION_A_GN_POSITIF_DATIF
Aoho4	L_GE_ADJECTIF_ORDINAL_APPOSITION_A_GN_POSITIF_ACCUSATIF
Aopo-	L_GE_ADJECTIF_ORDINAL_PREDICATIF_POSITIF
VC1	L_GE_VERBE_DANS_MOT_COMPOSE_POSITION_INITIALE
VC2	L_GE_VERBE_DANS_MOT_COMPOSE_POSITION_INTERMEDIAIRE
VC3	L_GE_VERBE_DANS_MOT_COMPOSE_POSITION_FINALE
Va-2	L_GE_VERBE_DE_PREDICATION_A_L'ACCUSATIF_IMPERATIF_2E_PERSONNE_SG/PL
Va-3	L_GE_VERBE_DE_PREDICATION_A_L'ACCUSATIF_IMPERATIF_1E/3E_PERSONNE_PL
Va-i	L_GE_VERBE_DE_PREDICATION_A_L'ACCUSATIF_INFINITIF_AVEC_ZU_INCORPORE
Va-n	L_GE_VERBE_DE_PREDICATION_A_L'ACCUSATIF_INFINITIF
Va-r	L_GE_VERBE_DE_PREDICATION_A_L'ACCUSATIF_PARTICIPE_PRESENT
Va-s	L_GE_VERBE_DE_PREDICATION_A_L'ACCUSATIF_PARTICIPE_PASSE
Va-z	L_GE_VERBE_DE_PREDICATION_A_L'ACCUSATIF_INFINITIF_AVEC_ZU
Vapj	L_GE_VERBE_DE_PREDICATION_A_L'ACCUSATIF_PHR_PRINCIPALE_INDICATIF/KONJUNKTIF
Vasj	L_GE_VERBE_DE_PREDICATION_A_L'ACCUSATIF_PHR_SUBORDONNEE_INDICATIF/KONJUNKTIF
Vatj	L_GE_VERBE_DE_PREDICATION_A_L'ACCUSATIF_PHR_INTERROG_TOTALE_INDICATIF/KONJUNKTIF
Vawj	L_GE_VERBE_DE_PREDICATION_A_L'ACCUSATIF_PHR_INTERROG_WH_INDICATIF/KONJUNKTIF
Vc-2	L_GE_VERBE_DE_COPULE_IMPERATIF_2E_PERSONNE_SG/PL
Vc-3	L_GE_VERBE_DE_COPULE_IMPERATIF_1E/3E_PERSONNE_PL
Vc-i	L_GE_VERBE_DE_COPULE_INFINITIF_AVEC_ZU_INCORPORE
Vc-n	L_GE_VERBE_DE_COPULE_INFINITIF
Vc-r	L_GE_VERBE_DE_COPULE_PARTICIPE_PRESENT
Vc-s	L_GE_VERBE_DE_COPULE_PARTICIPE_PASSE
Vc-z	L_GE_VERBE_DE_COPULE_INFINITIF_AVEC_ZU
Vcpj	L_GE_VERBE_DE_COPULE_PHR_PRINCIPALE_INDICATIF/KONJUNKTIF
Vcsj	L_GE_VERBE_DE_COPULE_PHR_SUBORDONNEE_INDICATIF/KONJUNKTIF
Vctj	L_GE_VERBE_DE_COPULE_PHR_INTERROG_TOTALE_INDICATIF/KONJUNKTIF
Vcwj	L_GE_VERBE_DE_COPULE_PHR_INTERROG_WH_INDICATIF/KONJUNKTIF
Vf-2	L_GE_VERBE_AUXILIAIRE_PASSIF_IMPERATIF_2E_PERSONNE_SG/PL
Vf-3	L_GE_VERBE_AUXILIAIRE_PASSIF_IMPERATIF_1E/3E_PERSONNE_PL
Vf-n	L_GE_VERBE_AUXILIAIRE_PASSIF_INFINITIF
Vf-r	L_GE_VERBE_AUXILIAIRE_PASSIF_PARTICIPE_PRESENT
Vf-s	L_GE_VERBE_AUXILIAIRE_PASSIF_PARTICIPE_PASSE
Vf-z	L_GE_VERBE_AUXILIAIRE_PASSIF_INFINITIF_AVEC_ZU
Vfpj	L_GE_VERBE_AUXILIAIRE_PASSIF_PHR_PRINCIPALE_INDICATIF/KONJUNKTIF
Vfsj	L_GE_VERBE_AUXILIAIRE_PASSIF_PHR_SUBORDONNEE_INDICATIF/KONJUNKTIF
Vftj	L_GE_VERBE_AUXILIAIRE_PASSIF_PHR_INTERROG_TOTALE_INDICATIF/KONJUNKTIF
Vfwj	L_GE_VERBE_AUXILIAIRE_PASSIF_PHR_INTERROG_WH_INDICATIF/KONJUNKTIF
Vi-2	L_GE_VERBE_IMPERSONNEL_IMPERATIF_2E_PERSONNE_SG/PL
Vi-3	L_GE_VERBE_IMPERSONNEL_IMPERATIF_1E/3E_PERSONNE_PL
Vi-n	L_GE_VERBE_IMPERSONNEL_INFINITIF
Vi-r	L_GE_VERBE_IMPERSONNEL_PARTICIPE_PRESENT
Vi-s	L_GE_VERBE_IMPERSONNEL_PARTICIPE_PASSE
Vi-z	L_GE_VERBE_IMPERSONNEL_INFINITIF_AVEC_ZU
Vipj	L_GE_VERBE_IMPERSONNEL_PHR_PRINCIPALE_INDICATIF/KONJUNKTIF
Visj	L_GE_VERBE_IMPERSONNEL_PHR_SUBORDONNEE_INDICATIF/KONJUNKTIF
Vitj	L_GE_VERBE_IMPERSONNEL_PHR_INTERROG_TOTALE_INDICATIF/KONJUNKTIF
Viwj	L_GE_VERBE_IMPERSONNEL_PHR_INTERROG_WH_INDICATIF/KONJUNKTIF
Vm-2	L_GE_VERBE_MODAL_IMPERATIF_2E_PERSONNE_SG/PL
Vm-3	L_GE_VERBE_MODAL_IMPERATIF_1E/3E_PERSONNE_PL
Vm-n	L_GE_VERBE_MODAL_INFINITIF
Vm-r	L_GE_VERBE_MODAL_PARTICIPE_PRESENT
Vm-s	L_GE_VERBE_MODAL_PARTICIPE_PASSE
Vm-z	L_GE_VERBE_MODAL_INFINITIF_AVEC_ZU
Vmpj	L_GE_VERBE_MODAL_PHR_PRINCIPALE_INDICATIF/KONJUNKTIF
Vmsj	L_GE_VERBE_MODAL_PHR_SUBORDONNEE_INDICATIF/KONJUNKTIF
Vmtj	L_GE_VERBE_MODAL_PHR_INTERROG_TOTALE_INDICATIF/KONJUNKTIF
Vmwj	L_GE_VERBE_MODAL_PHR_INTERROG_WH_INDICATIF/KONJUNKTIF
Vp-2	L_GE_VERBE_PRINCIPAL_IMPERATIF_2E_PERSONNE_SG/PL
Vp-3	L_GE_VERBE_PRINCIPAL_IMPERATIF_1E/3E_PERSONNE_PL
Vp-i	L_GE_VERBE_PRINCIPAL_INFINITIF_AVEC_ZU_INCORPORE
Vp-n	L_GE_VERBE_PRINCIPAL_INFINITIF
Vp-r	L_GE_VERBE_PRINCIPAL_PARTICIPE_PRESENT
Vp-s	L_GE_VERBE_PRINCIPAL_PARTICIPE_PASSE
Vp-z	L_GE_VERBE_PRINCIPAL_INFINITIF_AVEC_ZU
Vpc-	L_GE_VERBE_PRINCIPAL_DANS_MOT_COMPOSE
Vppj	L_GE_VERBE_PRINCIPAL_PHR_PRINCIPALE_INDICATIF/KONJUNKTIF
Vpsj	L_GE_VERBE_PRINCIPAL_PHR_SUBORDONNEE_INDICATIF/KONJUNKTIF
Vptj	L_GE_VERBE_PRINCIPAL_PHR_INTERROG_TOTALE_INDICATIF/KONJUNKTIF
Vpwj	L_GE_VERBE_PRINCIPAL_PHR_INTERROG_WH_INDICATIF/KONJUNKTIF
Vs-2	L_GE_VERBE_DE_COPULE_AVEC_ALS_IMPERATIF_2E_PERSONNE_SG/PL
Vs-3	L_GE_VERBE_DE_COPULE_AVEC_ALS_IMPERATIF_1E/3E_PERSONNE_PL
Vs-i	L_GE_VERBE_DE_COPULE_AVEC_ALS_INFINITIF_AVEC_ZU_INCORPORE
Vs-n	L_GE_VERBE_DE_COPULE_AVEC_ALS_INFINITIF
Vs-r	L_GE_VERBE_DE_COPULE_AVEC_ALS_PARTICIPE_PRESENT
Vs-s	L_GE_VERBE_DE_COPULE_AVEC_ALS_PARTICIPE_PASSE
Vs-z	L_GE_VERBE_DE_COPULE_AVEC_ALS_INFINITIF_AVEC_ZU
Vspj	L_GE_VERBE_DE_COPULE_AVEC_ALS_PHR_PRINCIPALE_INDICATIF/KONJUNKTIF
Vssj	L_GE_VERBE_DE_COPULE_AVEC_ALS_PHR_SUBORDONNEE_INDICATIF/KONJUNKTIF
Vstj	L_GE_VERBE_DE_COPULE_AVEC_ALS_PHR_INTERROG_TOTALE_INDICATIF/KONJUNKTIF
Vswj	L_GE_VERBE_DE_COPULE_AVEC_ALS_PHR_INTERROG_WH_INDICATIF/KONJUNKTIF
Vt-2	L_GE_VERBE_AUXILIAIRE_TEMPS_IMPERATIF_2E_PERSONNE_SG/PL
Vt-3	L_GE_VERBE_AUXILIAIRE_TEMPS_IMPERATIF_1E/3E_PERSONNE_PL
Vt-n	L_GE_VERBE_AUXILIAIRE_TEMPS_INFINITIF
Vt-r	L_GE_VERBE_AUXILIAIRE_TEMPS_PARTICIPE_PRESENT
Vt-s	L_GE_VERBE_AUXILIAIRE_TEMPS_PARTICIPE_PASSE
Vt-z	L_GE_VERBE_AUXILIAIRE_TEMPS_INFINITIF_AVEC_ZU
Vtpj	L_GE_VERBE_AUXILIAIRE_TEMPS_PHR_PRINCIPALE_INDICATIF/KONJUNKTIF
Vtsj	L_GE_VERBE_AUXILIAIRE_TEMPS_PHR_SUBORDONNEE_INDICATIF/KONJUNKTIF
Vttj	L_GE_VERBE_AUXILIAIRE_TEMPS_PHR_INTERROG_TOTALE_INDICATIF/KONJUNKTIF
Vtwj	L_GE_VERBE_AUXILIAIRE_TEMPS_PHR_INTERROG_WH_INDICATIF/KONJUNKTIF
RC1	L_GE_ADVERBE_DANS_MOT_COMPOSE_POSITION_INITIALE
RC2	L_GE_ADVERBE_DANS_MOT_COMPOSE_POSITION_INTERMEDIAIRE
RC3	L_GE_ADVERBE_DANS_MOT_COMPOSE_POSITION_FINALE
Rc-	L_GE_ADVERBE_COMPARAISON_APRES_CONJ_COORD
Rck	L_GE_ADVERBE_COMPARAISON_APRES_CONJ_COORD_COMPARATIF
Rco	L_GE_ADVERBE_COMPARAISON_APRES_CONJ_COORD_POSITIF
Rcs	L_GE_ADVERBE_COMPARAISON_APRES_CONJ_COORD_SUPERLATIF
Ri-	L_GE_ADVERBE_INFINITIF
Rik	L_GE_ADVERBE_INFINITIF_COMPARATIF
Rio	L_GE_ADVERBE_INFINITIF_POSITIF
Ris	L_GE_ADVERBE_INFINITIF_SUPERLATIF
Rn-	L_GE_ADVERBE_INTERIEUR_A_GN
Rnk	L_GE_ADVERBE_INTERIEUR_A_GN_COMPARATIF
Rno	L_GE_ADVERBE_INTERIEUR_A_GN_POSITIF
Rns	L_GE_ADVERBE_INTERIEUR_A_GN_SUPERLATIF
Ro-	L_GE_ADVERBE_INTERROG_TOTALE
Rok	L_GE_ADVERBE_INTERROG_TOTALE_COMPARATIF
Roo	L_GE_ADVERBE_INTERROG_TOTALE_POSITIF
Ros	L_GE_ADVERBE_INTERROG_TOTALE_SUPERLATIF
Rp-	L_GE_ADVERBE_PHR_PRINCIPALE
Rpk	L_GE_ADVERBE_PHR_PRINCIPALE_COMPARATIF
Rpo	L_GE_ADVERBE_PHR_PRINCIPALE_POSITIF
Rps	L_GE_ADVERBE_PHR_PRINCIPALE_SUPERLATIF
Rr-	L_GE_ADVERBE_PARTICIPE
Rrk	L_GE_ADVERBE_PARTICIPE_COMPARATIF
Rro	L_GE_ADVERBE_PARTICIPE_POSITIF
Rrs	L_GE_ADVERBE_PARTICIPE_SUPERLATIF
Rs-	L_GE_ADVERBE_PHR_SUBORDONNEE
Rsk	L_GE_ADVERBE_PHR_SUBORDONNEE_COMPARATIF
Rso	L_GE_ADVERBE_PHR_SUBORDONNEE_POSITIF
Rss	L_GE_ADVERBE_PHR_SUBORDONNEE_SUPERLATIF
Rw-	L_GE_ADVERBE_INTERROG_WH
Rwk	L_GE_ADVERBE_INTERROG_WH_COMPARATIF
Rwo	L_GE_ADVERBE_INTERROG_WH_POSITIF
Rws	L_GE_ADVERBE_INTERROG_WH_SUPERLATIF
Rx-	L_GE_ADVERBE_EXTRAPOSE
Rxk	L_GE_ADVERBE_EXTRAPOSE_COMPARATIF
Rxo	L_GE_ADVERBE_EXTRAPOSE_POSITIF
Rxs	L_GE_ADVERBE_EXTRAPOSE_SUPERLATIF
Sc21	L_GE_CIRCUMPOSITION_AVEC_GENITIF_1E_PARTIE
Sc22	L_GE_CIRCUMPOSITION_AVEC_GENITIF_2E_PARTIE
Sc31	L_GE_CIRCUMPOSITION_AVEC_DATIF_1E_PARTIE
Sc32	L_GE_CIRCUMPOSITION_AVEC_DATIF_2E_PARTIE
Sc41	L_GE_CIRCUMPOSITION_AVEC_ACCUSATIF_1E_PARTIE
Sc42	L_GE_CIRCUMPOSITION_AVEC_ACCUSATIF_2E_PARTIE
Sd3-	L_GE_PREPOSITION_PLUS_DETERMINANT_AVEC_DATIF
Sd4-	L_GE_PREPOSITION_PLUS_DETERMINANT_AVEC_ACCUSATIF
Se-a	L_GE_PREPOSITION_DEVANT_EXPR_ADV
Se2d	L_GE_PREPOSITION_AVEC_GENITIF_DEVANT_DET_GN
Se2n	L_GE_PREPOSITION_AVEC_GENITIF_DEVANT_GN_SANS_DET
Se3d	L_GE_PREPOSITION_AVEC_DATIF_DEVANT_DET_GN
Se3n	L_GE_PREPOSITION_AVEC_DATIF_DEVANT_GN_SANS_DET
Se4d	L_GE_PREPOSITION_AVEC_ACCUSATIF_DEVANT_DET_GN
Se4n	L_GE_PREPOSITION_AVEC_ACCUSATIF_DEVANT_GN_SANS_DET
Sg--	L_GE_PREPOSITION_TRADUISANT_GENITIF_DE_BASE
So2-	L_GE_POSTPOSITION_AVEC_GENITIF
So3-	L_GE_POSTPOSITION_AVEC_DATIF
So4-	L_GE_POSTPOSITION_AVEC_ACCUSATIF
Sp--	L_GE_PREPOSITION_AGENT_PASSIF
Sr--	L_GE_PREPOSITION_PARTIE_D'UN_NP
Ss--	L_GE_PREPOSITION_DEVANT_GROUPE_ADV_SUPERLATIF
St--	L_GE_PREPOSITION_DANS_EXPR_TEMP
Cc	L_GE_CONJONCTION_COORD_PHRASES
Cg	L_GE_CONJONCTION_COORD_GROUPES
Ci	L_GE_CONJONCTION_DEVANT_INFIN_AVEC_ZU
Cs	L_GE_CONJONCTION_SUBORD
Fb	L_GE_PONCTUATION_FAIBLE
Fe	L_GE_PONCTUATION_MISE_EN_EVIDENCE
Fm	L_GE_PONCTUATION_MORPHOLOGIQUE
Fp	L_GE_PONCTUATION_PARENTHESE
Ft	L_GE_PONCTUATION_FORTE
I	L_GE_INTERJECTION
Ee-	L_GE_DIVERS
Epg	L_GE_DIVERS_PARTICULE_GENERALE
Epn	L_GE_DIVERS_PARTICULE_DE_NEGATION
Epv	L_GE_DIVERS_PARTICULE_VERBALE_SEPAREE
