¿ 	L_PONCTU_FORTE_OUVRANTE
¡ 	L_PONCTU_FORTE_OUVRANTE
! 	L_PONCTU_FORTE_FERMANTE
EXCL	L_PONCTU_FORTE_FERMANTE
ELLIPSIS	L_PONCTU_FORTE_FERMANTE
" 	L_PONCTU_DIALOGUE
SLQUOTE	L_PONCTU_DIALOGUE
SQUOTE	L_PONCTU_DIALOGUE
DQUOTE	L_PONCTU_DIALOGUE
QUOTE	L_PONCTU_DIALOGUE
( 	L_PONCTU_PARENTHESE
LP	L_PONCTU_PARENTHESE
LB	L_PONCTU_PARENTHESE
LSQB	L_PONCTU_PARENTHESE
) 	L_PONCTU_PARENTHESE
RP	L_PONCTU_PARENTHESE
RB	L_PONCTU_PARENTHESE
RSQB	L_PONCTU_PARENTHESE
, 	L_PONCTU_FAIBLE
COLON	L_PONCTU_FAIBLE
CM	L_PONCTU_FAIBLE
AMPSD	L_PONCTU_FAIBLE
RAB	L_PONCTU_FAIBLE
DOLLAR	L_NOM_COMMUN_UNITE_DE_MESURE
PCTG	L_NOM_COMMUN_UNITE_DE_MESURE
- 	L_PONCTU_FAIBLE
DASH	L_PONCTU_FAIBLE
ASTRSK	L_PONCTU_FAIBLE
PLUS	L_PONCTU_FAIBLE
BACKSLASH	L_PONCTU_FAIBLE
SLASH	L_PONCTU_FAIBLE
PIPE	L_PONCTU_FAIBLE
CMFLEX	L_PONCTU_FAIBLE
EQ	L_PONCTU_FAIBLE
- 	L_PONCTU_DIALOGUE
. 	L_PONCTU_FORTE_FERMANTE
FS	L_PONCTU_FORTE_FERMANTE
... 	L_PONCTU_FORTE_FERMANTE
: 	L_PONCTU_FORTE_FERMANTE
; 	L_PONCTU_FORTE_FERMANTE
SEMICOLON	L_PONCTU_FORTE_FERMANTE
? 	L_PONCTU_FORTE_FERMANTE
QUEST	L_PONCTU_FORTE_FERMANTE
ADJCP 	L_ADJECTIF_COMPARATIF
ADJCS 	L_ADJECTIF_COMPARATIF
ADJGFP 	L_ADJECTIF_GENERAL
ADJGFS 	L_ADJECTIF_GENERAL
ADJGMP 	L_ADJECTIF_GENERAL
ADJGMPP 	L_ADJECTIF_GENERAL
ADJGMS 	L_ADJECTIF_GENERAL
AFJGMS	L_ADJECTIF_GENERAL
ADJMFP 	L_ADJECTIF_GENERAL
ADJMFS 	L_ADJECTIF_GENERAL
ADJFMS 	L_ADJECTIF_GENERAL
ADJMFP 	L_ADJECTIF_GENERAL
ADJFFS 	L_ADJECTIF_GENERAL
AJDGFS	L_ADJECTIF_GENERAL
VLPPMS	L_ADJECTIF_GENERAL
VLPPFS	L_ADJECTIF_GENERAL
VLPPMP	L_ADJECTIF_GENERAL
VLPPFP	L_ADJECTIF_GENERAL
PE3	L_ADJECTIF_GENERAL
ADJSFP 	L_ADJECTIF_SUPERLATIF
ADJSFS 	L_ADJECTIF_SUPERLATIF
ADJSMP 	L_ADJECTIF_SUPERLATIF
ADJSMS 	L_ADJECTIF_SUPERLATIF
ADVGR 	L_ADVERBE_GRADATION
ADVGRC 	L_ADVERBE_GRADATION_COMPARATIF
ADVGRS 	L_ADVERBE_GRADATION_SUPERLATIF
ADVINT 	L_ADVERBE_INTERROGATIF
ADVL 	L_ADVERBE_LIEU
ADVLD	L_ADVERBE_LIEU
ADVLE	L_ADVERBE_LIEU
ADVLIN	L_ADVERBE_LIEU
ADVLP	L_ADVERBE_LIEU
ADVLR	L_ADVERBE_LIEU
ADVLRE	L_ADVERBE_LIEU
ADVM 	L_ADVERBE_MANIERE
ADVMRE	L_ADVERBE_MANIERE
ADVMC 	L_ADVERBE_DE_MANIERE_CONCRETUDE_MODIF_ADV
ADVN 	L_ADVERBE_MODIF_SUBST_OU_PRON
ADVT 	L_ADVERBE_TEMPS
ADVTIN	L_ADVERBE_TEMPS
ADVTNE	L_ADVERBE_TEMPS
ADVTRE	L_ADVERBE_TEMPS
ADVX 	L_ADVERBE_TRANSCONSTRUCTIONNEL
ALFP 	L_DIVERS_LETTRE_ALPHABET
ALFS 	L_DIVERS_LETTRE_ALPHABET
UMMXX 	L_DIVERS_LETTRE_ALPHABET
ARTDFP 	L_DET_ARTICLE_DEF
ARTDFS 	L_DET_ARTICLE_DEF
ARTDMP 	L_DET_ARTICLE_DEF
ARTMP 	L_DET_ARTICLE_DEF
ARTDMS 	L_DET_ARTICLE_DEF
ARTDNS 	L_DET_ARTICLE_DEF
ARQUFP 	L_DET_ARTICLE_INDEF
ARQUFS 	L_DET_ARTICLE_INDEF
ARQUMP 	L_DET_ARTICLE_INDEF
ARQUMS 	L_DET_ARTICLE_INDEF
ARCAMS	L_DET_ARTICLE_INDEF
ARCAFS	L_DET_ARTICLE_INDEF
CARDGU 	L_CARDINAL_AVEC_TIRETS
CARD 	L_CARDINAL_AVEC_TIRETS
CARDN 	L_CARDINAL_NEUTRE
CARDPS	L_CARDINAL_NEUTRE
CARDXS	L_CARDINAL_NEUTRE
ROMAN	L_CARDINAL_NEUTRE
CARDXP	L_CARDINAL_NEUTRE
CARDP 	L_CARDINAL_PRONOMINAL
CC 	L_CONJ_COORD
CCNEG 	L_CONJ_COORD
CCAD 	L_CONJ_COORD_ADVERSATIVE
CQUE 	L_CONJ_QUE
CSUB 	L_CONJ_SUBORD
CSUBF	L_CONJ_COORD
CSUBI	L_CONJ_COORD
CSUBX	L_CONJ_COORD
DEMXFP 	L_DET_DEMONSTRATIF
DMPXMS	L_DET_DEMONSTRATIF
DMPXMP	L_DET_DEMONSTRATIF
DMPXFS	L_DET_DEMONSTRATIF
DMPXFP	L_DET_DEMONSTRATIF
DMDXFS	L_DET_DEMONSTRATIF
DMDXFP	L_DET_DEMONSTRATIF
DMDXMS	L_DET_DEMONSTRATIF
DMDXMP	L_DET_DEMONSTRATIF
DMDPMS	L_DET_DEMONSTRATIF
DMDPMP	L_DET_DEMONSTRATIF
DEMXFS	L_DET_DEMONSTRATIF
DEMXMP	L_DET_DEMONSTRATIF
DEMXMS	L_DET_DEMONSTRATIF
DMPPMS	L_DET_DEMONSTRATIF
DMPPMP	L_DET_DEMONSTRATIF
DMRXFS	L_DET_DEMONSTRATIF
DMRXFP	L_DET_DEMONSTRATIF
DMRXMS	L_DET_DEMONSTRATIF
DMRXMP	L_DET_DEMONSTRATIF
DMRPMS	L_PRON_DEMONSTRATIF
DMRPMP	L_PRON_DEMONSTRATIF
DMPPFS	L_PRON_DEMONSTRATIF
DMPPFP	L_PRON_DEMONSTRATIF
DEMPFS	L_PRON_DEMONSTRATIF
DEMPFP	L_PRON_DEMONSTRATIF
DMPPNS	L_PRON_DEMONSTRATIF
DMPPNP	L_PRON_DEMONSTRATIF
DEMPMP	L_PRON_DEMONSTRATIF
DEMPMS	L_PRON_DEMONSTRATIF
DEMPNS	L_PRON_DEMONSTRATIF
DEMPNP	L_PRON_DEMONSTRATIF
FO	L_DIVERS_FORMULE
FRAC	L_DIVERS_FRACTION
INTPXX	L_PRON_INTERROGATIF
INTPXP	L_PRON_INTERROGATIF
INTPXS	L_PRON_INTERROGATIF
INTXXX	L_DET_INTERROGATIF
INTXFP	L_DET_INTERROGATIF
INTXFS	L_DET_INTERROGATIF
INTXMP	L_DET_INTERROGATIF
INTXMS	L_DET_INTERROGATIF
INTXXP	L_DET_INTERROGATIF
INTXXS	L_DET_INTERROGATIF
ITJN	L_INTERJECTION	146
NCFP	L_NOM_COMMUN
NCFS	L_NOM_COMMUN
NCFSP	L_NOM_COMMUN
NCFSS	L_NOM_COMMUN
NCFX	L_NOM_COMMUN
NCMFP	L_NOM_COMMUN
NCMFS	L_NOM_COMMUN
NCMP	L_NOM_COMMUN
NCMS	L_NOM_COMMUN
MCMS	L_NOM_COMMUN
NCMSP	L_NOM_COMMUN
NCMSS	L_NOM_COMMUN
NCMX	L_NOM_COMMUN
NEG	L_ADVERBE_NEG
ADVNEG	L_ADVERBE_NEG
NLOCFP	L_NOM_LOCATION
NLOCFS	L_NOM_LOCATION
NLOCMP	L_NOM_LOCATION
NLOCMS	L_NOM_LOCATION
NNUMFP	L_NOM_NUMERAL
NNUMFS	L_NOM_NUMERAL
NNUMMP	L_NOM_NUMERAL
NNUMMS	L_NOM_NUMERAL
NMON	L_NOM_TEMPS
NORGFP	L_NOM_ORGANISATION
NORGFS	L_NOM_ORGANISATION
NORGMP	L_NOM_ORGANISATION
NORGMS	L_NOM_ORGANISATION
ACRNM	L_NOM_ORGANISATION
ACRNM/	L_NOM_ORGANISATION
NPGX	L_NOM_ORGANISATION
NPAFP 	L_NOM_PROPRE_ANTHROPONYME
NPAFS 	L_NOM_PROPRE_ANTHROPONYME
NPAMP 	L_NOM_PROPRE_ANTHROPONYME
NPAMS 	L_NOM_PROPRE_ANTHROPONYME
NPAXX 	L_NOM_PROPRE_ANTHROPONYME
APPX 	L_NOM_PROPRE_ANTHROPONYME
NPTOS 	L_NOM_PROPRE_TOPONYME_OU_ORGANISATION
NPTS 	L_NOM_PROPRE_TOPONYME_OU_ORGANISATION
NTMPFP 	L_NOM_TEMPS
NTMPFS 	L_NOM_TEMPS
NTMPMP 	L_NOM_TEMPS
NTMPMS 	L_NOM_TEMPS
NTOPP 	L_NOM_PROPRE_TOPONYME_OU_ORGANISATION
ORDNMS 	L_ADJECTIF_NUM_ORD
ORDPMS 	L_PRON_NUM_ORD
ORDXFP 	L_PRON_ADJ_NUM_ORD
ORDXFS 	L_PRON_ADJ_NUM_ORD
ORDXMP 	L_PRON_ADJ_NUM_ORD
ORDXMS 	L_PRON_ADJ_NUM_ORD
QUXFP	L_PRON_ADJ_NUM_ORD
QUXFS	L_PRON_ADJ_NUM_ORD
QUXNFS	L_PRON_ADJ_NUM_ORD
QUXMP	L_PRON_ADJ_NUM_ORD
QUXMS	L_PRON_ADJ_NUM_ORD
PAL 	L_DET_ARTICLE_CONTRACTE_A_EL
PDEL 	L_DET_ARTICLE_CONTRACTE_DE_EL
PE 	L_DIVERS_MOT_ETRANGER
PNC 	L_DIVERS_AUTRE
??	L_DIVERS_AUTRE
???	L_DIVERS_AUTRE
DATE	L_DIVERS_AUTRE
CODE	L_DIVERS_AUTRE
PPC1P 	L_PRON_PERSONNEL_CLITIQUE
PPC1S 	L_PRON_PERSONNEL_CLITIQUE
PPC2P 	L_PRON_PERSONNEL_CLITIQUE
PPC2S 	L_PRON_PERSONNEL_CLITIQUE
PPC3P 	L_PRON_PERSONNEL_CLITIQUE
PPC3S 	L_PRON_PERSONNEL_CLITIQUE
PPN1S 	L_PRON_PERSONNEL_SUJET
PPN2S 	L_PRON_PERSONNEL_SUJET
PPO3FP 	L_PRON_PERSONNEL_CLITIQUE_COD
PPO3FS 	L_PRON_PERSONNEL_CLITIQUE_COD
PPO3MP 	L_PRON_PERSONNEL_CLITIQUE_COD
PPO3XS 	L_PRON_PERSONNEL_CLITIQUE_COD
PPOSFP 	L_PRON_POSSESSIF
PPOSFS 	L_PRON_POSSESSIF
PPOSMP 	L_PRON_POSSESSIF
PPOSMS 	L_PRON_POSSESSIF
PPOSPP 	L_PRON_POSSESSIF_PREN
PPOSPS 	L_PRON_POSSESSIF_PREN
PPP1S 	L_PRON_PERSONNEL_PREPOSITIF
PPP2S 	L_PRON_PERSONNEL_PREPOSITIF
PPP3X 	L_PRON_PERSONNEL_PREPOSITIF
PPX1FP 	L_PRON_PERSONNEL_SUJET_OU_PREPOSITIF
PPX2FP 	L_PRON_PERSONNEL_SUJET_OU_PREPOSITIF
PPX2MP 	L_PRON_PERSONNEL_SUJET_OU_PREPOSITIF
PPX3FP 	L_PRON_PERSONNEL_SUJET_OU_PREPOSITIF
PPX3FS 	L_PRON_PERSONNEL_SUJET_OU_PREPOSITIF
PPX3MP 	L_PRON_PERSONNEL_SUJET_OU_PREPOSITIF
PPX3MS 	L_PRON_PERSONNEL_SUJET_OU_PREPOSITIF
PPX3NS 	L_PRON_PERSONNEL_SUJET_OU_PREPOSITIF
PPXT2P 	L_PRON_PERSONNEL_SUJET_OU_PREPOSITIF_FORME_POLIE
PPXT2S 	L_PRON_PERSONNEL_SUJET_OU_PREPOSITIF_FORME_POLIE
PREP 	L_PREPOSITION
PREPN	L_PREPOSITION
PREPP	L_PREPOSITION
QUDF 	L_QUANTIFICATEUR_DISTRIBUTIF
QUDM 	L_QUANTIFICATEUR_DISTRIBUTIF
QUDX 	L_QUANTIFICATEUR_DISTRIBUTIF
QUMUL 	L_QUANTIFICATEUR_MULTIPLE
QUPMUL 	L_QUANTIFICATEUR_MULTIPLE
QUPMULMS 	L_QUANTIFICATEUR_MULTIPLE
QUNMS 	L_QUANTIFICATEUR_NOM_PRONOMINAL
QUNNMS 	L_QUANTIFICATEUR_NOM_PRONOMINAL
QUNFS	L_QUANTIFICATEUR_NOM_PRONOMINAL
QUNMP	L_QUANTIFICATEUR_NOM_PRONOMINAL
QUNFP	L_QUANTIFICATEUR_NOM_PRONOMINAL
QUPNI	L_QUANTIFICATEUR_NOM_PRONOMINAL
QUPMS	L_QUANTIFICATEUR_PRONOMINAL
QUPNX	L_QUANTIFICATEUR_PRONOMINAL_OU_NON
QUXFP 	L_QUANTIFICATEUR_PRONOMINAL_OU_NON
QUXFS 	L_QUANTIFICATEUR_PRONOMINAL_OU_NON
QUXMP 	L_QUANTIFICATEUR_PRONOMINAL_OU_NON
QUXMS 	L_QUANTIFICATEUR_PRONOMINAL_OU_NON
RELP 	L_PRON_RELATIF
RELPFP 	L_PRON_RELATIF_POSSESSIF
RELPFS 	L_PRON_RELATIF_POSSESSIF
RELPMP 	L_PRON_RELATIF_POSSESSIF
RELPMS 	L_PRON_RELATIF_POSSESSIF
RELPXP 	L_PRON_RELATIF
RELPXS 	L_PRON_RELATIF
RELXFP 	L_PRON_DET_RELATIF
RELXFS 	L_PRON_DET_RELATIF
RELXMP 	L_PRON_DET_RELATIF
RELXMS 	L_PRON_DET_RELATIF
SE 	L_PARTICULE_SE	94
TRATF 	L_NOM_COMMUN_ANNONCEUR_NP
TRATM 	L_NOM_COMMUN_ANNONCEUR_NP
UMFP 	L_NOM_COMMUN_UNITE_DE_MESURE
UMFS 	L_NOM_COMMUN_UNITE_DE_MESURE
UMFX 	L_NOM_COMMUN_UNITE_DE_MESURE
UMMP 	L_NOM_COMMUN_UNITE_DE_MESURE
UMMS 	L_NOM_COMMUN_UNITE_DE_MESURE
UMMSN 	L_NOM_COMMUN_UNITE_DE_MESURE
NMEAMP	L_NOM_COMMUN_UNITE_DE_MESURE
UMMX	L_NOM_COMMUN_UNITE_DE_MESURE
NMEAMS	L_NOM_COMMUN_UNITE_DE_MESURE
PERCT	L_NOM_COMMUN_UNITE_DE_MESURE
VECI1P 	L_VERBE_ESTAR_INDICATIF
VECI1S 	L_VERBE_ESTAR_INDICATIF
VECI2P 	L_VERBE_ESTAR_INDICATIF
VECI2S 	L_VERBE_ESTAR_INDICATIF
VECI3P 	L_VERBE_ESTAR_INDICATIF
VECI3S 	L_VERBE_ESTAR_INDICATIF
VEFI1P 	L_VERBE_ESTAR_INDICATIF
VEFI1S 	L_VERBE_ESTAR_INDICATIF
VEFI2P 	L_VERBE_ESTAR_INDICATIF
VEFI2S 	L_VERBE_ESTAR_INDICATIF
VEFI3P 	L_VERBE_ESTAR_INDICATIF
VEFI3S 	L_VERBE_ESTAR_INDICATIF
VEFS1P 	L_VERBE_ESTAR_SUBJONCTIF
VEFS1S 	L_VERBE_ESTAR_SUBJONCTIF
FS2P 	L_VERBE_ESTAR_SUBJONCTIF
VEFS2S 	L_VERBE_ESTAR_SUBJONCTIF
VEFS3P 	L_VERBE_ESTAR_SUBJONCTIF
VEFS3S 	L_VERBE_ESTAR_SUBJONCTIF
VEGER 	L_VERBE_ESTAR_GERONDIF
VEII1P 	L_VERBE_ESTAR_INDICATIF
VEII1S 	L_VERBE_ESTAR_INDICATIF
VEII2P 	L_VERBE_ESTAR_INDICATIF
VEII2S 	L_VERBE_ESTAR_INDICATIF
VEII3P 	L_VERBE_ESTAR_INDICATIF
VEII3S 	L_VERBE_ESTAR_INDICATIF
VEINF 	L_VERBE_ESTAR_INFINITIF
VEIS1P 	L_VERBE_ESTAR_SUBJONCTIF
VEIS1S 	L_VERBE_ESTAR_SUBJONCTIF
VEIS2P 	L_VERBE_ESTAR_SUBJONCTIF
VEIS2S 	L_VERBE_ESTAR_SUBJONCTIF
VEIS3P 	L_VERBE_ESTAR_SUBJONCTIF
VEIS3S 	L_VERBE_ESTAR_SUBJONCTIF
VEPA	L_VERBE_ESTAR_PARTICIPE
VEPX	L_VERBE_ESTAR_PARTICIPE
VEPI1P 	L_VERBE_ESTAR_INDICATIF
VEPI1S 	L_VERBE_ESTAR_INDICATIF
VEPI2P 	L_VERBE_ESTAR_INDICATIF
VEPI2S 	L_VERBE_ESTAR_INDICATIF
VEPI3P 	L_VERBE_ESTAR_INDICATIF
VEPI3S 	L_VERBE_ESTAR_INDICATIF
VEPM2P 	L_VERBE_ESTAR_IMPERATIF
VEPM2S 	L_VERBE_ESTAR_IMPERATIF
VEPS1P 	L_VERBE_ESTAR_SUBJONCTIF
VEPS1S 	L_VERBE_ESTAR_SUBJONCTIF
VEPS2P 	L_VERBE_ESTAR_SUBJONCTIF
VEPS2S 	L_VERBE_ESTAR_SUBJONCTIF
VEPS3P 	L_VERBE_ESTAR_SUBJONCTIF
VEPS3S 	L_VERBE_ESTAR_SUBJONCTIF
VEXI1P 	L_VERBE_ESTAR_INDICATIF
VEXI1S 	L_VERBE_ESTAR_INDICATIF
VEXI2P 	L_VERBE_ESTAR_INDICATIF
VEXI2S 	L_VERBE_ESTAR_INDICATIF
VEXI3P 	L_VERBE_ESTAR_INDICATIF
VEXI3S 	L_VERBE_ESTAR_INDICATIF
VHCI1P 	L_VERBE_HABER_INDICATIF
VHCI1S 	L_VERBE_HABER_INDICATIF
VHCI2P 	L_VERBE_HABER_INDICATIF
VHCI2S 	L_VERBE_HABER_INDICATIF
VHCI3P 	L_VERBE_HABER_INDICATIF
VHCI3S 	L_VERBE_HABER_INDICATIF
VHFI1P 	L_VERBE_HABER_INDICATIF
VHFI1S 	L_VERBE_HABER_INDICATIF
VHFI2P 	L_VERBE_HABER_INDICATIF
VHFI2S 	L_VERBE_HABER_INDICATIF
VHFI3P 	L_VERBE_HABER_INDICATIF
VHFI3S 	L_VERBE_HABER_INDICATIF
VHFS1P 	L_VERBE_HABER_SUBJONCTIF
VHFS1S 	L_VERBE_HABER_SUBJONCTIF
VHFS2P 	L_VERBE_HABER_SUBJONCTIF
VHFS2S 	L_VERBE_HABER_SUBJONCTIF
VHFS3P 	L_VERBE_HABER_SUBJONCTIF
VHFS3S 	L_VERBE_HABER_SUBJONCTIF
VHGER 	L_VERBE_HABER_GERONDIF
VHII1P 	L_VERBE_HABER_INDICATIF
VHII1S 	L_VERBE_HABER_INDICATIF
VHII2P 	L_VERBE_HABER_INDICATIF
VHII2S 	L_VERBE_HABER_INDICATIF
VHII3P 	L_VERBE_HABER_INDICATIF
VHII3S 	L_VERBE_HABER_INDICATIF
VHINF 	L_VERBE_HABER_INFINITIF
VHIS1P 	L_VERBE_HABER_SUBJONCTIF
VHIS1S 	L_VERBE_HABER_SUBJONCTIF
VHIS2P 	L_VERBE_HABER_SUBJONCTIF
VHIS2S 	L_VERBE_HABER_SUBJONCTIF
VHIS3P 	L_VERBE_HABER_SUBJONCTIF
VHIS3S 	L_VERBE_HABER_SUBJONCTIF
VHPAFP 	L_VERBE_HABER_PARTICIPE
VHPAFS 	L_VERBE_HABER_PARTICIPE
VHPAMP 	L_VERBE_HABER_PARTICIPE
VHPAFS 	L_VERBE_HABER_PARTICIPE
VHPI1P 	L_VERBE_HABER_INDICATIF
VHPI1S 	L_VERBE_HABER_INDICATIF
VHPI2P 	L_VERBE_HABER_INDICATIF
VHPI2S 	L_VERBE_HABER_INDICATIF
VHPI3P 	L_VERBE_HABER_INDICATIF
VHPI3E	L_VERBE_HABER_INDICATIF
VHPI3S 	L_VERBE_HABER_INDICATIF
VHPM2P 	L_VERBE_HABER_IMPERATIF
VHPM2S 	L_VERBE_HABER_IMPERATIF
VHPS1P 	L_VERBE_HABER_SUBJONCTIF
VHPS1S 	L_VERBE_HABER_SUBJONCTIF
VHPS2P 	L_VERBE_HABER_SUBJONCTIF
VHPS2S 	L_VERBE_HABER_SUBJONCTIF
VHPS3P 	L_VERBE_HABER_SUBJONCTIF
VHPS3S 	L_VERBE_HABER_SUBJONCTIF
VHXI1P 	L_VERBE_HABER_INDICATIF
VHXI1S 	L_VERBE_HABER_INDICATIF
VHXI2P 	L_VERBE_HABER_INDICATIF
VHXI2S 	L_VERBE_HABER_INDICATIF
VHXI3P 	L_VERBE_HABER_INDICATIF
VHXI3S 	L_VERBE_HABER_INDICATIF
VLCI1P 	L_VERBE_GENERAL_INDICATIF
VLCI1S 	L_VERBE_GENERAL_INDICATIF
VLCI2P 	L_VERBE_GENERAL_INDICATIF
VLCI2S 	L_VERBE_GENERAL_INDICATIF
VLCI3P 	L_VERBE_GENERAL_INDICATIF
VLCI3S 	L_VERBE_GENERAL_INDICATIF
VLFI1P 	L_VERBE_GENERAL_INDICATIF
VLFI1S 	L_VERBE_GENERAL_INDICATIF
VLFI2P 	L_VERBE_GENERAL_INDICATIF
VLFI2S 	L_VERBE_GENERAL_INDICATIF
VLFI3P 	L_VERBE_GENERAL_INDICATIF
VLFI3S 	L_VERBE_GENERAL_INDICATIF
VLFS1P 	L_VERBE_GENERAL_SUBJONCTIF
VLFS1S 	L_VERBE_GENERAL_SUBJONCTIF
VLFS2P 	L_VERBE_GENERAL_SUBJONCTIF
VLFS2S 	L_VERBE_GENERAL_SUBJONCTIF
VLFS3P 	L_VERBE_GENERAL_SUBJONCTIF
VLFS3S 	L_VERBE_GENERAL_SUBJONCTIF
VLGER 	L_VERBE_GENERAL_GERONDIF
VLII1P 	L_VERBE_GENERAL_INDICATIF
VLII1S 	L_VERBE_GENERAL_INDICATIF
VLII2P 	L_VERBE_GENERAL_INDICATIF
VLII2S 	L_VERBE_GENERAL_INDICATIF
VLII3P 	L_VERBE_GENERAL_INDICATIF
VLII3S 	L_VERBE_GENERAL_INDICATIF
VLINF 	L_VERBE_GENERAL_INFINITIF
VCLI	L_VERBE_GENERAL_INFINITIF
VLIS1P 	L_VERBE_GENERAL_SUBJONCTIF
VLIS1S 	L_VERBE_GENERAL_SUBJONCTIF
VLIS2P 	L_VERBE_GENERAL_SUBJONCTIF
VLIS2S 	L_VERBE_GENERAL_SUBJONCTIF
VLIS3P 	L_VERBE_GENERAL_SUBJONCTIF
VLIS3S 	L_VERBE_GENERAL_SUBJONCTIF
VLPAFP 	L_VERBE_GENERAL_PARTICIPE
VLPAFS 	L_VERBE_GENERAL_PARTICIPE
VLPAMP 	L_VERBE_GENERAL_PARTICIPE
VLPAMS 	L_VERBE_GENERAL_PARTICIPE
VLPXMS	L_VERBE_GENERAL_PARTICIPE
VLPXFS	L_VERBE_GENERAL_PARTICIPE
VLPXFP	L_VERBE_GENERAL_PARTICIPE
VLPXMP	L_VERBE_GENERAL_PARTICIPE
VLPPFP	L_VERBE_GENERAL_PARTICIPE
VLPPFS	L_VERBE_GENERAL_PARTICIPE
VLPPMP	L_VERBE_GENERAL_PARTICIPE
VLPPMS	L_VERBE_GENERAL_PARTICIPE
VLPI1P 	L_VERBE_GENERAL_INDICATIF
VLPI1S 	L_VERBE_GENERAL_INDICATIF
VLPI2P 	L_VERBE_GENERAL_INDICATIF
VLPI2S 	L_VERBE_GENERAL_INDICATIF
VLPI3P 	L_VERBE_GENERAL_INDICATIF
VLPI3S 	L_VERBE_GENERAL_INDICATIF
VLPM2P 	L_VERBE_GENERAL_IMPERATIF
VLPM2S 	L_VERBE_GENERAL_IMPERATIF
VLPS1P 	L_VERBE_GENERAL_SUBJONCTIF
VLPS1S 	L_VERBE_GENERAL_SUBJONCTIF
VLPS2P 	L_VERBE_GENERAL_SUBJONCTIF
VLPS2S 	L_VERBE_GENERAL_SUBJONCTIF
VLPS3P 	L_VERBE_GENERAL_SUBJONCTIF
VLPS3S 	L_VERBE_GENERAL_SUBJONCTIF
VLXI1P 	L_VERBE_GENERAL_INDICATIF
VLXI1S 	L_VERBE_GENERAL_INDICATIF
VLXI2P 	L_VERBE_GENERAL_INDICATIF
VLXI2S 	L_VERBE_GENERAL_INDICATIF
VLXI3P 	L_VERBE_GENERAL_INDICATIF
VLXI3S 	L_VERBE_GENERAL_INDICATIF
VMCI1P 	L_VERBE_DE_MODALITE_INDICATIF
VMCI1S 	L_VERBE_DE_MODALITE_INDICATIF
VMCI2P 	L_VERBE_DE_MODALITE_INDICATIF
VMCI2S 	L_VERBE_DE_MODALITE_INDICATIF
VMCI3P 	L_VERBE_DE_MODALITE_INDICATIF
VMCI3S 	L_VERBE_DE_MODALITE_INDICATIF
VMFI1P 	L_VERBE_DE_MODALITE_INDICATIF
VMFI1S 	L_VERBE_DE_MODALITE_INDICATIF
VMFI2P 	L_VERBE_DE_MODALITE_INDICATIF
VMFI2S 	L_VERBE_DE_MODALITE_INDICATIF
VMFI3P 	L_VERBE_DE_MODALITE_INDICATIF
VMFI3S 	L_VERBE_DE_MODALITE_INDICATIF
VMFS1P 	L_VERBE_DE_MODALITE_SUBJONCTIF
VMFS1S 	L_VERBE_DE_MODALITE_SUBJONCTIF
VMFS2P 	L_VERBE_DE_MODALITE_SUBJONCTIF
VMFS2S 	L_VERBE_DE_MODALITE_SUBJONCTIF
VMFS3P 	L_VERBE_DE_MODALITE_SUBJONCTIF
VMFS3S 	L_VERBE_DE_MODALITE_SUBJONCTIF
VMGER 	L_VERBE_DE_MODALITE_GERONDIF
VMII1P 	L_VERBE_DE_MODALITE_INDICATIF
VMII1S 	L_VERBE_DE_MODALITE_INDICATIF
VMII2P 	L_VERBE_DE_MODALITE_INDICATIF
VMII2S 	L_VERBE_DE_MODALITE_INDICATIF
VMII3P 	L_VERBE_DE_MODALITE_INDICATIF
VMII3S 	L_VERBE_DE_MODALITE_INDICATIF
VMINF 	L_VERBE_DE_MODALITE_INFINITIF
VMIS1P 	L_VERBE_DE_MODALITE_SUBJONCTIF
VMIS1S 	L_VERBE_DE_MODALITE_SUBJONCTIF
VMIS2P 	L_VERBE_DE_MODALITE_SUBJONCTIF
VMIS2S 	L_VERBE_DE_MODALITE_SUBJONCTIF
VMIS3P 	L_VERBE_DE_MODALITE_SUBJONCTIF
VMIS3S 	L_VERBE_DE_MODALITE_SUBJONCTIF
VMPA 	L_VERBE_DE_MODALITE_PARTICIPE
VMPX 	L_VERBE_DE_MODALITE_PARTICIPE
VMPI1P 	L_VERBE_DE_MODALITE_INDICATIF
VMPI1S 	L_VERBE_DE_MODALITE_INDICATIF
VMPI2P 	L_VERBE_DE_MODALITE_INDICATIF
VMPI2S 	L_VERBE_DE_MODALITE_INDICATIF
VMPI3P 	L_VERBE_DE_MODALITE_INDICATIF
VMPI3S 	L_VERBE_DE_MODALITE_INDICATIF
VMPI3E 	L_VERBE_DE_MODALITE_INDICATIF
VMPM2P 	L_VERBE_DE_MODALITE_IMPERATIF
VMPM2S 	L_VERBE_DE_MODALITE_IMPERATIF
VMPS1P 	L_VERBE_DE_MODALITE_SUBJONCTIF
VMPS1S 	L_VERBE_DE_MODALITE_SUBJONCTIF
VMPS2P 	L_VERBE_DE_MODALITE_SUBJONCTIF
VMPS2S 	L_VERBE_DE_MODALITE_SUBJONCTIF
VMPS3P 	L_VERBE_DE_MODALITE_SUBJONCTIF
VMPS3S 	L_VERBE_DE_MODALITE_SUBJONCTIF
VMXI1P 	L_VERBE_DE_MODALITE_INDICATIF
VMXI1S 	L_VERBE_DE_MODALITE_INDICATIF
VMXI2P 	L_VERBE_DE_MODALITE_INDICATIF
VMXI2S 	L_VERBE_DE_MODALITE_INDICATIF
VMXI3P 	L_VERBE_DE_MODALITE_INDICATIF
VMXI3S 	L_VERBE_DE_MODALITE_INDICATIF
VSCI1P 	L_VERBE_SER_INDICATIF
VSCI1S 	L_VERBE_SER_INDICATIF
VSCI2P 	L_VERBE_SER_INDICATIF
VSCI2S 	L_VERBE_SER_INDICATIF
VSCI3P 	L_VERBE_SER_INDICATIF
VSCI3S 	L_VERBE_SER_INDICATIF
VSFI1P 	L_VERBE_SER_INDICATIF
VSFI1S 	L_VERBE_SER_INDICATIF
VSFI2P 	L_VERBE_SER_INDICATIF
VSFI2S 	L_VERBE_SER_INDICATIF
VSFI3P 	L_VERBE_SER_INDICATIF
VSFI3S 	L_VERBE_SER_INDICATIF
VSFS1P 	L_VERBE_SER_SUBJONCTIF
VSFS1S 	L_VERBE_SER_SUBJONCTIF
VSFS2P 	L_VERBE_SER_SUBJONCTIF
VSFS2S 	L_VERBE_SER_SUBJONCTIF
VSFS3P 	L_VERBE_SER_SUBJONCTIF
VSFS3S 	L_VERBE_SER_SUBJONCTIF
VSGER 	L_VERBE_SER_GERONDIF
VSII1P 	L_VERBE_SER_INDICATIF
VSII1S 	L_VERBE_SER_INDICATIF
VSII2P 	L_VERBE_SER_INDICATIF
VSII2S 	L_VERBE_SER_INDICATIF
VSII3P 	L_VERBE_SER_INDICATIF
VSII3S 	L_VERBE_SER_INDICATIF
VSINF 	L_VERBE_SER_INFINITIF
VSIS1P 	L_VERBE_SER_SUBJONCTIF
VSIS1S 	L_VERBE_SER_SUBJONCTIF
VSIS2P 	L_VERBE_SER_SUBJONCTIF
VSIS2S 	L_VERBE_SER_SUBJONCTIF
VSIS3P 	L_VERBE_SER_SUBJONCTIF
VSIS3S 	L_VERBE_SER_SUBJONCTIF
VSPA 	L_VERBE_SER_PARTICIPE
VSPX 	L_VERBE_SER_PARTICIPE
VSPI1P 	L_VERBE_SER_INDICATIF
VSPI1S 	L_VERBE_SER_INDICATIF
VSPI2P 	L_VERBE_SER_INDICATIF
VSPI2S 	L_VERBE_SER_INDICATIF
VSPI3P 	L_VERBE_SER_INDICATIF
VSPI3S 	L_VERBE_SER_INDICATIF
VSPM2P 	L_VERBE_SER_IMPERATIF
VSPM2S 	L_VERBE_SER_IMPERATIF
VSPS1P 	L_VERBE_SER_SUBJONCTIF
VSPS1S 	L_VERBE_SER_SUBJONCTIF
VSPS2P 	L_VERBE_SER_SUBJONCTIF
VSPS2S 	L_VERBE_SER_SUBJONCTIF
VSPS3P 	L_VERBE_SER_SUBJONCTIF
VSPS3S 	L_VERBE_SER_SUBJONCTIF
VSXI1P 	L_VERBE_SER_INDICATIF
VSXI1S 	L_VERBE_SER_INDICATIF
VSXI2P 	L_VERBE_SER_INDICATIF
VSXI2S 	L_VERBE_SER_INDICATIF
VSXI3P 	L_VERBE_SER_INDICATIF
VSXI3S 	L_VERBE_SER_INDICATIF
